VEHICULO;VEHICULO;FECHA_ENTRADA;FECHA_SALIDA;MINUTOS;SOC_ENTRADA;SOC_SALIDA;DIF_SOC
34;31;2018-04-19 03:38:31.477;2018-04-19 07:19:43.357;221;34;92;58
31;31;2018-04-24 11:52:53.700;2018-04-24 13:16:33.680;84;34;89;55
31;31;2018-04-26 09:46:15.610;2018-04-26 11:40:34.203;114;28;89;61
31;31;2018-04-27 07:23:00.913;2018-04-27 09:28:14.673;125;33;89;56
31;31;2018-05-15 13:42:32.933;2018-05-15 13:59:34.010;17;34;39;5
31;31;2018-05-15 14:01:03.303;2018-05-15 15:21:06.517;80;39;89;50
31;31;2018-05-17 09:54:12.597;2018-05-17 12:02:17.347;128;34;89;55
31;31;2018-05-18 10:22:14.360;2018-05-18 13:17:10.283;175;34;89;55
31;31;2018-05-21 09:58:46.927;2018-05-21 13:47:13.170;229;34;90;56
31;31;2018-05-22 14:24:38.600;2018-05-22 15:50:53.050;86;34;89;55
31;31;2018-04-09 09:15:42.600;2018-04-09 11:08:54.303;113;34;89;55
31;31;2018-04-13 10:32:29.010;2018-04-13 12:06:46.147;94;34;89;55
31;31;2018-05-14 04:03:06.050;2018-05-14 05:39:20.573;96;32;89;57
31;31;2018-05-26 12:12:28.070;2018-05-26 15:08:08.847;176;87;100;13
31;31;2018-05-29 17:41:04.180;2018-05-29 19:46:10.847;125;34;89;55
31;31;2018-05-31 17:27:57.210;2018-05-31 19:29:22.973;122;33;89;56
31;31;2018-06-25 22:57:36.980;2018-06-26 00:26:54.063;89;34;89;55
31;31;2018-06-26 15:53:41.677;2018-06-26 17:21:44.583;88;34;89;55
31;31;2018-07-12 09:15:13.730;2018-07-12 10:57:24.310;102;31;89;58
31;31;2018-07-13 09:38:12.450;2018-07-13 12:36:24.390;178;33;89;56
34;34;2018-01-04 17:36:48.853;2018-01-04 19:22:22.420;106;34;89;55
34;34;2018-01-04 17:40:59.900;2018-01-04 19:22:22.420;102;34;89;55
34;34;2018-01-19 15:06:19.640;2018-01-19 16:55:06.733;109;32;89;57
35;35;2017-10-02 06:36:53.600;2017-10-02 08:05:05.403;89;34;96;62
35;35;2017-10-04 00:13:36.667;2017-10-04 01:39:22.363;86;34;89;55
35;35;2017-10-04 00:20:10.687;2017-10-04 01:39:22.363;79;34;89;55
35;35;2017-10-04 00:31:55.320;2017-10-04 01:39:22.363;68;34;89;55
35;35;2017-10-04 11:48:01.503;2017-10-04 12:57:18.270;69;34;89;55
35;35;2017-10-04 11:51:37.207;2017-10-04 12:57:18.270;66;34;89;55
35;35;2017-10-09 08:00:43.107;2017-10-09 09:08:43.567;68;34;89;55
35;35;2017-10-10 21:44:25.127;2017-10-10 22:55:41.030;71;33;89;56
35;35;2017-10-16 07:47:03.663;2017-10-16 09:02:04.497;75;34;89;55
35;35;2017-10-13 10:44:40.083;2017-10-13 11:56:11.470;72;34;89;55
35;35;2017-10-18 04:00:21.580;2017-10-18 05:25:07.370;85;34;89;55
35;35;2017-10-23 20:59:54.540;2017-10-24 10:53:04.957;834;33;89;56
35;35;2017-10-25 16:21:13.327;2017-10-25 17:31:34.840;70;34;89;55
35;35;2017-10-27 05:12:02.997;2017-10-27 06:31:13.330;79;34;89;55
31;31;2018-07-16 10:18:40.767;2018-07-16 11:57:07.153;99;33;89;56
35;35;2017-11-01 22:01:41.287;2017-11-01 23:18:58.830;77;30;89;59
35;35;2017-11-03 13:27:01.067;2017-11-03 14:43:56.787;76;33;89;56
35;35;2017-11-03 13:32:00.690;2017-11-03 14:43:56.787;71;33;89;56
35;35;2017-11-06 10:42:04.367;2017-11-06 11:53:55.013;71;33;89;56
31;31;2018-07-17 07:16:32.030;2018-07-17 08:44:39.320;88;34;89;55
35;35;2017-11-14 07:48:16.837;2017-11-15 11:13:12.060;1645;22;89;67
35;35;2017-11-14 07:53:10.973;2017-11-15 11:13:12.060;1640;22;89;67
35;35;2017-11-14 07:58:50.250;2017-11-15 11:13:12.060;1635;22;89;67
31;31;2018-07-18 08:14:56.857;2018-07-18 09:45:50.037;91;34;89;55
31;31;2018-07-18 08:17:25.513;2018-07-18 09:45:50.037;88;34;89;55
31;31;2018-07-18 08:18:13.587;2018-07-18 09:45:50.037;87;34;89;55
31;31;2018-07-19 03:05:41.643;2018-07-19 04:37:22.427;92;32;89;57
35;35;2017-11-22 07:57:59.040;2017-11-22 11:07:33.097;190;34;89;55
35;35;2017-11-24 05:47:50.617;2017-11-24 12:46:24.893;419;30;89;59
35;35;2017-11-25 12:01:32.620;2017-11-25 17:09:11.460;308;51;100;49
31;31;2018-07-19 19:24:35.503;2018-07-19 20:42:57.793;78;34;89;55
34;34;2018-02-16 02:33:32.010;2018-02-16 04:00:49.367;87;34;89;55
35;35;2017-11-30 14:02:39.993;2017-11-30 15:53:43.077;111;34;89;55
35;35;2017-11-29 20:59:47.283;2017-11-29 22:43:33.077;104;34;89;55
35;35;2017-12-01 04:46:43.213;2017-12-01 06:41:38.010;115;34;89;55
31;31;2018-08-03 13:18:27.220;2018-08-04 08:16:31.710;1138;52;89;37
31;31;2018-08-04 06:35:16.613;2018-08-04 08:16:31.710;101;33;89;56
31;31;2018-08-04 12:01:55.663;2018-08-06 08:22:49.310;2661;83;92;9
31;31;2018-08-06 06:34:26.343;2018-08-06 08:22:49.310;108;44;92;48
31;31;2018-08-07 01:36:10.720;2018-08-07 06:32:40.003;296;34;100;66
34;34;2018-02-20 08:40:34.433;2018-02-22 13:38:39.050;3178;32;100;68
34;34;2018-02-22 09:41:00.157;2018-02-22 13:38:39.050;237;34;100;66
34;34;2018-02-22 09:43:58.173;2018-02-22 13:38:39.050;235;34;100;66
34;34;2018-02-26 08:40:43.213;2018-02-26 10:24:51.900;104;33;89;56
34;34;2018-02-26 09:03:19.457;2018-02-26 10:24:51.900;81;33;89;56
35;35;2017-12-02 12:01:01.870;2017-12-02 17:01:26.197;300;60;100;40
31;31;2018-08-16 11:35:44.837;2018-08-16 12:23:39.463;48;59;89;30
35;35;2017-12-12 11:44:58.103;2017-12-12 13:05:16.550;81;33;75;42
35;35;2017-12-14 05:47:23.053;2017-12-14 07:09:11.663;82;45;89;44
35;35;2017-12-19 07:23:21.767;2017-12-19 09:01:24.710;98;34;83;49
35;35;2017-12-19 18:19:20.903;2017-12-19 20:07:12.253;108;33;89;56
35;35;2017-12-20 12:46:07.230;2017-12-20 12:51:50.780;5;86;89;3
34;34;2018-02-06 01:01:19.487;2018-02-06 03:10:05.960;129;34;89;55
34;34;2018-02-06 01:04:51.610;2018-02-06 03:10:05.960;126;34;89;55
34;34;2018-02-12 19:21:51.920;2018-02-13 00:13:39.853;292;28;100;72
34;34;2018-02-12 19:29:00.767;2018-02-13 00:13:39.853;284;28;100;72
34;34;2018-02-14 11:15:42.570;2018-02-14 12:39:17.133;84;34;89;55
34;34;2018-02-28 07:31:48.033;2018-02-28 08:45:41.347;74;34;89;55
34;34;2018-02-28 08:52:30.977;2018-02-28 08:53:05.080;1;88;89;1
34;34;2018-02-28 21:52:08.047;2018-02-28 23:07:48.403;75;34;89;55
34;34;2018-03-01 15:46:15.633;2018-03-01 17:19:53.597;93;34;89;55
35;35;2017-12-21 08:15:58.970;2017-12-21 10:42:21.307;147;33;70;37
34;34;2018-03-05 01:59:08.490;2018-03-05 03:31:01.987;92;29;89;60
35;35;2017-12-21 18:25:42.870;2017-12-21 20:11:34.203;106;34;89;55
35;35;2017-12-26 13:23:23.613;2017-12-26 15:05:15.083;102;34;89;55
35;35;2017-12-27 19:46:56.580;2017-12-27 21:35:54.993;109;33;89;56
35;35;2018-01-03 04:13:55.910;2018-01-03 06:04:52.500;111;33;89;56
34;34;2018-03-09 04:36:05.217;2018-03-09 06:06:37.280;90;34;89;55
35;35;2018-01-09 06:44:44.510;2018-01-09 08:28:36.597;104;34;89;55
35;35;2018-01-11 10:23:48.200;2018-01-11 12:05:12.050;102;33;89;56
35;35;2018-01-15 11:35:01.697;2018-01-15 13:13:28.980;98;33;89;56
35;35;2018-01-16 18:59:20.997;2018-01-16 20:41:09.153;102;34;89;55
35;35;2018-01-17 13:05:57.620;2018-01-17 14:44:41.340;99;34;89;55
31;31;2018-08-23 15:41:58.087;2018-08-23 17:34:11.740;113;34;89;55
31;31;2018-08-23 15:50:40.373;2018-08-23 17:34:11.740;104;34;89;55
31;31;2018-09-06 11:13:15.157;2018-09-06 12:41:26.280;88;34;89;55
35;35;2018-01-16 07:24:37.877;2018-01-16 08:33:39.473;69;34;72;38
35;35;2018-01-19 14:54:54.673;2018-01-19 16:40:47.683;106;33;89;56
31;31;2018-09-28 11:04:59.127;2018-09-28 12:25:40.280;81;34;85;51
31;31;2018-08-24 10:21:14.043;2018-08-24 12:06:57.870;105;34;89;55
35;35;2018-01-21 23:37:13.767;2018-01-23 03:08:52.027;1651;33;100;67
35;35;2018-01-23 00:51:04.273;2018-01-23 03:08:52.027;137;34;100;66
35;35;2018-01-23 00:52:14.097;2018-01-23 03:08:52.027;136;34;100;66
34;34;2018-03-09 18:55:10.717;2018-03-09 20:20:27.380;85;34;89;55
35;35;2018-01-30 08:08:36.497;2018-01-30 09:55:48.570;107;34;89;55
35;35;2018-01-30 08:12:41.670;2018-01-30 09:55:48.570;103;34;89;55
35;35;2018-01-31 00:59:34.627;2018-01-31 02:37:33.510;98;33;89;56
35;35;2018-02-02 12:10:42.337;2018-02-02 13:55:06.630;105;33;89;56
35;35;2018-02-02 12:13:46.600;2018-02-02 13:55:06.630;102;33;89;56
35;35;2018-02-02 12:16:26.523;2018-02-02 13:55:06.630;99;33;89;56
31;31;2018-09-17 13:05:30.157;2018-09-17 15:19:13.370;134;42;97;55
34;34;2018-04-05 11:27:15.510;2018-04-05 14:19:01.320;172;34;89;55
31;31;2018-09-18 13:21:07.713;2018-09-19 11:09:29.453;1308;34;79;45
35;35;2018-02-16 02:35:55.790;2018-02-16 03:58:09.137;83;40;89;49
35;35;2018-02-18 22:04:00.453;2018-02-19 00:04:15.110;120;30;89;59
35;35;2018-02-19 17:04:06.213;2018-02-19 18:44:20.880;100;34;89;55
35;35;2018-02-19 17:06:41.833;2018-02-19 18:44:20.880;98;34;89;55
31;31;2018-09-21 01:48:01.447;2018-09-21 03:07:33.210;79;33;89;56
31;31;2018-09-21 16:37:58.987;2018-09-21 17:59:07.157;82;34;89;55
31;31;2018-09-24 10:10:30.737;2018-09-24 15:36:17.393;326;33;100;67
31;31;2018-09-24 10:25:05.823;2018-09-24 15:36:17.393;311;33;100;67
35;35;2018-02-26 12:23:09.983;2018-02-26 13:37:04.700;74;34;89;55
35;35;2018-02-26 12:23:25.980;2018-02-26 13:37:04.700;74;34;89;55
35;35;2018-02-27 04:41:50.830;2018-02-27 05:57:33.853;76;34;89;55
31;31;2018-04-05 11:52:19.850;2018-04-05 13:14:03.107;82;33;89;56
31;31;2018-01-29 13:05:48.590;2018-03-21 13:06:05.553;73441;64;92;28
31;31;2018-04-17 13:08:49.920;2018-04-17 15:26:17.987;138;33;88;55
31;31;2018-04-25 07:44:44.233;2018-04-25 09:13:49.733;89;34;89;55
31;31;2018-04-06 04:29:45.270;2018-04-06 05:54:05.673;85;34;89;55
31;31;2018-04-12 05:05:24.753;2018-04-12 06:26:01.593;81;34;89;55
31;31;2018-04-12 18:05:43.567;2018-04-12 19:27:53.020;82;34;89;55
31;31;2018-05-11 04:09:31.440;2018-05-11 05:34:19.260;85;34;89;55
31;31;2018-05-26 12:14:30.617;2018-05-26 15:08:08.847;174;87;100;13
31;31;2018-05-14 20:37:55.847;2018-05-14 22:08:51.763;91;34;89;55
31;31;2018-05-28 23:12:39.200;2018-05-29 01:19:23.280;127;33;89;56
31;31;2018-06-05 15:29:55.793;2018-06-05 19:26:49.937;237;33;100;67
31;31;2018-06-22 09:06:59.663;2018-06-22 10:37:06.943;91;34;89;55
31;31;2018-06-24 22:11:53.843;2018-06-25 02:45:23.603;274;15;97;82
31;31;2018-07-12 09:14:34.653;2018-07-12 10:57:24.310;103;31;89;58
31;31;2018-07-12 09:16:08.843;2018-07-12 10:57:24.310;101;31;89;58
31;31;2018-07-13 09:02:50.590;2018-07-13 12:36:24.390;214;33;89;56
35;35;2017-10-02 06:24:51.960;2017-10-02 08:05:05.403;101;34;96;62
35;35;2017-10-02 12:37:05.220;2017-10-02 15:22:49.420;165;79;100;21
35;35;2017-10-09 18:49:30.783;2017-10-09 19:58:07.240;69;34;89;55
35;35;2017-10-18 17:31:58.603;2017-10-18 18:49:21.450;78;33;89;56
35;35;2017-10-19 13:53:36.810;2017-10-19 14:54:46.127;61;33;79;46
35;35;2017-10-19 13:54:41.280;2017-10-19 14:54:46.127;60;33;79;46
35;35;2017-10-19 14:00:31.540;2017-10-19 14:54:46.127;54;33;79;46
35;35;2017-10-29 22:17:16.797;2017-10-30 02:54:00.950;277;15;100;85
35;35;2017-10-29 22:18:51.650;2017-10-30 02:54:00.950;276;15;100;85
35;35;2017-11-03 13:29:56.890;2017-11-03 14:43:56.787;74;33;89;56
35;35;2017-11-08 12:00:58.710;2017-11-08 12:45:47.380;45;57;89;32
35;35;2017-11-09 08:27:06.410;2017-11-09 09:27:43.153;60;32;89;57
35;35;2017-11-14 07:42:32.847;2017-11-15 11:13:12.060;1651;25;89;64
35;35;2017-11-14 07:50:05.473;2017-11-15 11:13:12.060;1643;22;89;67
35;35;2017-11-14 07:54:54.547;2017-11-15 11:13:12.060;1639;22;89;67
35;35;2017-11-14 07:57:30.937;2017-11-15 11:13:12.060;1636;22;89;67
35;35;2017-11-14 08:11:42.473;2017-11-15 11:13:12.060;1622;20;89;69
35;35;2017-11-14 08:12:39.183;2017-11-15 11:13:12.060;1621;20;89;69
35;35;2017-11-13 16:53:40.940;2017-11-15 11:13:12.060;2540;33;89;56
35;35;2017-11-15 09:56:43.207;2017-11-15 11:13:12.060;77;20;89;69
35;35;2017-11-16 19:28:50.257;2017-11-16 20:30:25.350;62;33;87;54
34;34;2018-01-05 18:32:02.560;2018-01-05 20:25:08.123;113;33;89;56
34;34;2018-01-05 18:33:24.797;2018-01-05 20:25:08.123;112;33;89;56
34;34;2018-01-15 05:47:01.483;2018-01-17 17:43:34.050;3596;30;89;59
34;34;2018-01-15 05:48:24.977;2018-01-17 17:43:34.050;3595;30;89;59
34;34;2018-01-18 12:39:47.113;2018-01-18 14:27:13.257;108;34;89;55
34;34;2018-01-24 10:18:45.723;2018-01-24 15:41:41.850;323;22;100;78
34;34;2018-01-26 01:46:50.957;2018-01-26 01:54:48.790;8;84;89;5
34;34;2018-01-29 06:21:43.770;2018-01-29 06:24:20.207;3;87;89;2
35;35;2017-11-21 08:56:08.230;2017-11-21 10:05:24.847;69;33;89;56
35;35;2017-11-22 09:57:16.350;2017-11-22 11:07:33.097;70;34;89;55
35;35;2017-11-24 05:49:02.527;2017-11-24 12:46:24.893;417;30;89;59
35;35;2017-11-24 05:50:52.487;2017-11-24 12:46:24.893;416;30;89;59
35;35;2017-11-23 08:44:41.220;2017-11-23 09:54:24.833;70;34;89;55
35;35;2017-11-27 11:12:57.847;2017-11-27 12:29:45.867;77;34;73;39
35;35;2017-11-28 00:30:41.840;2017-11-28 02:18:20.430;108;34;89;55
35;35;2017-11-28 15:39:30.543;2017-11-28 17:26:47.240;107;34;84;50
35;35;2017-11-28 17:29:21.183;2017-11-28 17:38:29.920;9;84;89;5
31;31;2018-07-20 10:28:55.863;2018-07-20 11:47:49.013;79;33;89;56
31;31;2018-08-01 14:26:42.727;2018-08-01 16:06:09.997;100;34;89;55
34;34;2018-02-16 19:42:54.587;2018-02-16 21:09:55.737;87;34;89;55
35;35;2017-12-01 19:40:11.790;2017-12-01 21:40:28.120;120;34;89;55
31;31;2018-08-16 06:49:32.600;2018-08-16 11:34:59.137;285;48;59;11
35;35;2017-12-04 11:47:22.750;2017-12-04 13:00:38.987;73;34;73;39
35;35;2017-12-09 12:13:18.300;2017-12-09 17:14:06.170;301;58;100;42
35;35;2017-12-09 12:14:05.010;2017-12-09 17:14:06.170;300;58;100;42
35;35;2017-12-11 17:47:59.190;2017-12-11 19:43:03.380;116;34;89;55
35;35;2017-12-13 16:08:43.303;2017-12-13 17:59:12.613;111;34;89;55
35;35;2017-12-15 13:26:52.267;2017-12-15 15:20:18.570;114;33;89;56
35;35;2017-12-16 12:00:55.747;2017-12-16 15:07:55.493;187;45;100;55
35;35;2017-12-18 09:12:45.173;2017-12-18 10:54:27.327;102;34;89;55
34;34;2018-02-23 08:13:32.267;2018-02-23 09:32:22.337;79;34;89;55
34;34;2018-02-26 08:36:03.293;2018-02-26 10:24:51.900;108;33;89;56
34;34;2018-02-26 08:55:46.000;2018-02-26 10:24:51.900;89;33;89;56
34;34;2018-02-05 07:30:50.237;2018-02-05 09:28:22.837;118;34;89;55
34;34;2018-02-05 07:31:47.063;2018-02-05 09:28:22.837;117;34;89;55
34;34;2018-02-07 12:03:56.460;2018-02-07 14:30:24.590;147;33;89;56
34;34;2018-02-07 12:16:08.373;2018-02-07 14:30:24.590;134;33;89;56
34;34;2018-02-08 08:52:08.710;2018-02-08 11:13:37.917;141;34;89;55
34;34;2018-02-09 03:42:26.773;2018-02-09 06:05:52.507;143;33;89;56
34;34;2018-02-12 19:05:56.660;2018-02-13 00:13:39.853;308;28;100;72
34;34;2018-02-12 19:27:34.443;2018-02-13 00:13:39.853;286;28;100;72
34;34;2018-02-13 17:37:03.707;2018-02-13 19:06:39.990;89;34;89;55
34;34;2018-03-05 15:44:59.367;2018-03-05 16:09:59.790;25;33;48;15
35;35;2017-12-21 07:55:31.707;2017-12-21 10:42:21.307;167;33;70;37
35;35;2017-12-21 07:56:51.943;2017-12-21 10:42:21.307;166;33;70;37
35;35;2017-12-21 08:00:19.603;2017-12-21 10:42:21.307;162;33;70;37
35;35;2017-12-21 09:28:45.410;2017-12-21 10:42:21.307;74;33;70;37
34;34;2018-03-05 01:37:22.667;2018-03-05 03:31:01.987;114;29;89;60
34;34;2018-03-06 07:46:07.400;2018-03-06 09:09:23.827;83;34;89;55
35;35;2017-12-26 11:47:56.477;2017-12-26 15:05:15.083;198;34;89;55
31;31;2018-08-21 05:59:17.857;2018-08-21 11:06:33.217;307;4;93;89
35;35;2017-12-30 12:02:16.190;2017-12-30 17:24:32.560;322;64;100;36
31;31;2018-08-22 07:59:03.023;2018-08-22 09:37:45.097;98;34;89;55
31;31;2018-08-22 07:57:52.490;2018-08-22 09:37:45.097;100;34;89;55
35;35;2018-01-04 15:26:44.493;2018-01-04 17:19:46.220;113;34;89;55
34;34;2018-03-07 00:12:58.357;2018-03-07 01:35:15.097;83;33;89;56
35;35;2018-01-10 13:29:27.937;2018-01-10 15:10:32.023;101;33;89;56
35;35;2018-01-18 12:01:43.173;2018-01-18 13:43:09.623;102;34;89;55
31;31;2018-09-06 10:13:07.423;2018-09-06 12:41:26.280;148;34;89;55
35;35;2018-01-24 03:59:12.420;2018-01-24 05:49:19.160;110;31;89;58
35;35;2018-01-21 23:35:06.533;2018-01-23 03:08:52.027;1653;33;100;67
35;35;2018-01-23 00:15:32.690;2018-01-23 03:08:52.027;173;34;100;66
35;35;2018-01-23 00:21:22.007;2018-01-23 03:08:52.027;167;34;100;66
31;31;2018-09-09 23:18:13.213;2018-09-10 00:56:43.140;98;33;89;56
31;31;2018-09-09 23:25:42.440;2018-09-10 00:56:43.140;91;31;89;58
35;35;2018-01-29 02:33:21.737;2018-01-29 04:22:43.713;109;34;89;55
35;35;2018-01-25 22:47:34.353;2018-01-26 00:31:48.580;104;34;89;55
34;34;2018-03-13 08:05:27.220;2018-03-13 09:32:14.120;87;34;89;55
34;34;2018-04-02 17:14:10.607;2018-04-02 19:37:02.833;143;33;89;56
34;34;2018-04-03 12:22:40.150;2018-04-03 14:46:57.120;144;34;89;55
35;35;2018-01-29 17:22:35.837;2018-01-29 18:57:19.443;95;33;89;56
31;31;2018-09-15 10:04:10.333;2018-09-17 13:05:18.020;3061;39;42;3
31;31;2018-09-15 10:05:58.940;2018-09-17 13:05:18.020;3060;39;42;3
31;31;2018-09-17 12:35:22.110;2018-09-17 13:05:18.020;30;33;42;9
31;31;2018-09-19 10:02:35.813;2018-09-19 11:09:29.453;67;33;79;46
35;35;2018-02-14 13:20:23.443;2018-02-15 14:42:38.320;1522;84;89;5
35;35;2018-02-20 16:18:40.030;2018-02-20 17:33:00.143;75;34;89;55
31;31;2018-09-23 22:30:55.190;2018-09-23 22:41:25.603;11;32;35;3
31;31;2018-09-24 03:19:18.730;2018-09-24 15:36:17.393;737;33;100;67
35;35;2018-02-22 19:14:26.217;2018-02-22 20:30:14.823;76;34;89;55
35;35;2018-02-23 15:11:53.177;2018-02-23 16:33:55.103;82;31;89;58
35;35;2018-03-14 22:43:49.870;2018-03-15 00:06:11.003;83;32;89;57
31;31;2018-05-25 07:00:59.643;2018-05-25 08:20:05.283;80;34;89;55
35;35;2018-03-16 12:03:39.657;2018-03-16 13:22:37.023;79;34;89;55
31;31;2018-06-11 01:46:56.853;2018-06-11 04:53:04.780;187;17;100;83
31;31;2018-06-11 02:05:12.710;2018-06-11 04:53:04.780;168;17;100;83
31;31;2018-06-11 02:53:51.657;2018-06-11 04:53:04.780;120;28;100;72
31;31;2018-06-13 09:58:05.310;2018-06-13 11:36:07.423;98;33;89;56
31;31;2018-06-28 08:13:45.117;2018-07-02 19:19:07.007;6426;34;89;55
31;31;2018-05-23 11:00:47.910;2018-05-23 12:35:05.330;95;34;89;55
31;31;2018-04-13 10:43:59.570;2018-04-13 12:06:46.147;83;34;89;55
31;31;2018-05-26 12:18:57.470;2018-05-26 15:08:08.847;170;86;100;14
31;31;2018-05-30 12:50:40.623;2018-05-30 14:24:21.123;94;34;89;55
31;31;2018-05-31 14:44:56.213;2018-05-31 15:23:57.843;39;34;35;1
31;31;2018-05-31 17:42:15.737;2018-05-31 19:29:22.973;107;33;89;56
31;31;2018-06-04 13:28:15.330;2018-06-05 19:26:49.937;1798;34;100;66
31;31;2018-06-18 04:34:43.107;2018-06-20 01:29:17.853;2695;34;100;66
31;31;2018-06-18 07:13:11.260;2018-06-20 01:29:17.853;2536;34;100;66
31;31;2018-06-19 02:15:54.210;2018-06-20 01:29:17.853;1394;33;100;67
31;31;2018-06-19 20:56:26.690;2018-06-20 01:29:17.853;273;33;100;67
31;31;2018-06-21 12:35:34.100;2018-06-21 14:06:38.970;91;34;89;55
31;31;2018-06-24 22:09:25.660;2018-06-25 02:45:23.603;276;15;97;82
31;31;2018-06-27 14:25:47.610;2018-06-27 15:57:58.187;92;33;89;56
35;35;2017-10-02 06:26:47.283;2017-10-02 08:05:05.403;99;34;96;62
35;35;2017-10-03 09:24:16.690;2017-10-03 10:52:18.023;88;34;89;55
35;35;2017-10-03 09:39:25.060;2017-10-03 10:52:18.023;73;34;89;55
35;35;2017-10-05 15:46:17.097;2017-10-05 16:53:12.223;67;34;89;55
35;35;2017-10-06 09:24:20.460;2017-10-06 10:33:44.337;69;33;89;56
35;35;2017-10-16 19:06:31.590;2017-10-16 20:20:45.470;74;34;89;55
35;35;2017-10-18 03:43:14.137;2017-10-18 05:25:07.370;102;34;89;55
35;35;2017-10-18 03:58:26.057;2017-10-18 05:25:07.370;87;34;89;55
35;35;2017-10-20 05:25:27.167;2017-10-20 06:48:53.760;83;34;92;58
35;35;2017-10-22 21:54:42.430;2017-10-23 02:42:41.883;288;19;100;81
35;35;2017-10-22 21:57:41.807;2017-10-23 02:42:41.883;285;19;100;81
31;31;2018-07-12 09:16:51.080;2018-07-12 10:57:24.310;101;31;89;58
31;31;2018-07-13 08:54:03.537;2018-07-13 12:36:24.390;222;33;89;56
31;31;2018-07-13 09:27:26.093;2018-07-13 12:36:24.390;189;33;89;56
35;35;2017-10-23 21:04:18.300;2017-10-24 10:53:04.957;829;33;89;56
35;35;2017-10-25 02:21:41.383;2017-10-25 03:33:07.123;72;34;89;55
35;35;2017-10-27 05:16:07.170;2017-10-27 06:31:13.330;75;34;89;55
35;35;2017-10-27 05:21:07.060;2017-10-27 06:31:13.330;70;34;89;55
35;35;2017-10-29 22:20:47.970;2017-10-30 02:54:00.950;274;15;100;85
35;35;2017-10-30 18:29:49.147;2017-10-30 19:35:16.460;66;33;89;56
35;35;2017-11-03 13:32:39.137;2017-11-03 14:43:56.787;71;33;89;56
35;35;2017-11-07 05:31:40.880;2017-11-07 06:45:12.320;74;34;89;55
35;35;2017-11-07 17:46:57.287;2017-11-07 19:00:13.787;74;34;89;55
35;35;2017-11-10 00:14:16.010;2017-11-10 01:15:41.267;61;32;89;57
35;35;2017-11-16 01:04:19.657;2017-11-16 02:09:12.047;65;34;89;55
35;35;2017-11-14 07:34:47.650;2017-11-15 11:13:12.060;1659;30;89;59
35;35;2017-11-14 07:36:51.093;2017-11-15 11:13:12.060;1657;27;89;62
35;35;2017-11-14 07:41:26.673;2017-11-15 11:13:12.060;1652;25;89;64
35;35;2017-11-14 07:46:50.990;2017-11-15 11:13:12.060;1647;22;89;67
35;35;2017-11-14 08:04:41.720;2017-11-15 11:13:12.060;1629;22;89;67
35;35;2017-11-14 08:13:53.200;2017-11-15 11:13:12.060;1620;20;89;69
35;35;2017-11-14 09:57:15.720;2017-11-15 11:13:12.060;1516;20;89;69
35;35;2017-11-14 12:40:18.620;2017-11-15 11:13:12.060;1353;20;89;69
35;35;2017-11-16 20:31:54.670;2017-11-16 20:35:27.963;4;86;89;3
34;34;2018-01-04 17:38:43.803;2018-01-04 19:22:22.420;104;34;89;55
34;34;2018-01-18 12:40:31.727;2018-01-18 14:27:13.257;107;34;89;55
34;34;2018-01-25 19:59:08.310;2018-01-25 21:52:20.833;113;34;89;55
34;34;2018-01-29 02:30:08.547;2018-01-29 04:25:23.007;115;34;89;55
34;34;2018-01-29 05:14:11.307;2018-01-29 05:15:26.337;1;88;89;1
34;34;2018-01-30 12:28:38.777;2018-01-30 14:24:50.820;116;34;89;55
34;34;2018-01-30 12:29:27.750;2018-01-30 14:24:50.820;115;34;89;55
35;35;2017-11-24 10:42:26.293;2017-11-24 12:46:24.893;124;30;89;59
35;35;2017-11-27 12:30:40.553;2017-11-27 13:00:21.663;30;73;89;16
35;35;2017-11-28 15:48:48.877;2017-11-28 17:26:47.240;98;34;84;50
35;35;2017-11-28 15:50:49.643;2017-11-28 17:26:47.240;96;34;84;50
31;31;2018-08-01 14:33:03.937;2018-08-01 16:06:09.997;93;34;89;55
31;31;2018-08-02 11:12:08.450;2018-08-02 12:42:20.077;90;34;89;55
31;31;2018-08-02 11:16:41.013;2018-08-02 12:42:20.077;86;34;89;55
31;31;2018-08-03 05:17:22.530;2018-08-03 06:45:34.860;88;33;89;56
31;31;2018-08-16 10:52:59.690;2018-08-16 11:34:59.137;42;34;59;25
34;34;2018-02-02 07:43:51.357;2018-02-02 09:42:40.210;119;34;89;55
34;34;2018-02-20 08:41:22.783;2018-02-22 13:38:39.050;3177;32;100;68
34;34;2018-02-20 08:42:18.160;2018-02-22 13:38:39.050;3176;32;100;68
35;35;2017-12-04 13:03:58.193;2017-12-04 13:21:06.563;18;73;81;8
35;35;2017-12-14 18:33:33.837;2017-12-14 20:26:16.280;113;33;89;56
34;34;2018-02-07 12:07:40.370;2018-02-07 14:30:24.590;143;33;89;56
34;34;2018-02-07 12:11:40.557;2018-02-07 14:30:24.590;139;33;89;56
34;34;2018-02-07 12:14:26.100;2018-02-07 14:30:24.590;136;33;89;56
34;34;2018-02-15 08:37:53.970;2018-02-15 10:02:37.060;85;33;89;56
34;34;2018-02-28 07:30:45.387;2018-02-28 08:45:41.347;75;34;89;55
34;34;2018-03-02 09:07:38.220;2018-03-02 10:25:07.663;78;33;89;56
35;35;2017-12-21 08:05:54.957;2017-12-21 10:42:21.307;157;33;70;37
34;34;2018-03-05 16:13:32.087;2018-03-05 17:08:46.050;55;48;89;41
35;35;2017-12-22 16:06:22.180;2017-12-22 17:52:23.933;106;34;89;55
35;35;2017-12-27 06:26:12.957;2017-12-27 08:11:47.307;105;34;89;55
35;35;2017-12-28 11:59:53.363;2017-12-28 13:47:36.497;108;34;89;55
35;35;2017-12-29 11:37:49.240;2017-12-29 13:24:19.953;107;34;89;55
31;31;2018-08-22 07:47:44.580;2018-08-22 09:37:45.097;110;34;89;55
34;34;2018-03-07 14:34:29.850;2018-03-07 15:55:11.360;81;34;89;55
34;34;2018-03-08 12:41:46.053;2018-03-08 14:01:37.477;80;34;89;55
35;35;2018-01-05 13:14:30.337;2018-01-05 15:05:58.203;111;34;89;55
35;35;2018-01-08 11:58:46.823;2018-01-08 13:28:50.010;90;34;89;55
35;35;2018-01-17 12:58:37.827;2018-01-17 14:44:41.340;106;34;89;55
31;31;2018-09-28 11:06:59.050;2018-09-28 12:25:40.280;79;34;85;51
31;31;2018-09-28 11:07:36.500;2018-09-28 12:25:40.280;78;34;85;51
35;35;2018-01-21 23:36:08.367;2018-01-23 03:08:52.027;1652;33;100;67
35;35;2018-01-23 00:53:13.220;2018-01-23 03:08:52.027;135;34;100;66
35;35;2018-01-25 03:50:23.937;2018-01-25 05:37:57.453;107;33;89;56
31;31;2018-09-10 18:07:19.310;2018-09-10 19:42:22.593;95;31;89;58
31;31;2018-09-11 11:36:16.713;2018-09-11 13:07:09.117;91;33;89;56
31;31;2018-09-12 07:48:41.007;2018-09-12 09:28:59.920;100;33;89;56
35;35;2018-02-01 14:10:23.653;2018-02-01 15:48:36.460;98;33;89;56
31;31;2018-09-15 10:04:55.597;2018-09-17 13:05:18.020;3061;39;42;3
31;31;2018-09-15 10:07:03.090;2018-09-17 13:05:18.020;3058;39;42;3
31;31;2018-09-15 09:36:55.447;2018-09-17 13:05:18.020;3089;39;42;3
31;31;2018-09-15 09:38:15.173;2018-09-17 13:05:18.020;3087;39;42;3
34;34;2018-04-02 17:23:35.120;2018-04-02 19:37:02.833;134;33;89;56
35;35;2018-01-31 20:21:06.030;2018-01-31 21:59:11.140;98;34;89;55
35;35;2018-02-21 09:50:35.980;2018-02-21 11:05:54.523;75;33;89;56
35;35;2018-02-23 15:15:10.383;2018-02-23 16:33:55.103;78;31;89;58
31;31;2018-09-25 13:31:25.240;2018-09-25 15:09:37.583;98;33;89;56
31;31;2018-09-26 09:45:33.070;2018-09-26 22:00:12.143;735;34;89;55
31;31;2018-09-26 11:29:23.250;2018-09-26 22:00:12.143;631;34;89;55
31;31;2018-09-26 20:09:24.430;2018-09-26 22:00:12.143;111;33;89;56
31;31;2018-05-24 11:16:36.823;2018-05-24 12:46:52.250;90;34;89;55
34;34;2018-04-07 07:00:02.400;2018-04-07 08:56:23.330;116;34;89;55
31;31;2018-06-11 01:36:12.357;2018-06-11 04:53:04.780;197;17;100;83
31;31;2018-06-11 01:52:05.297;2018-06-11 04:53:04.780;181;17;100;83
31;31;2018-06-11 02:53:09.993;2018-06-11 04:53:04.780;120;28;100;72
31;31;2018-06-14 20:48:24.147;2018-06-14 22:18:13.670;90;33;89;56
31;31;2018-06-28 08:07:27.443;2018-07-02 19:19:07.007;6432;34;89;55
31;31;2018-06-28 08:09:44.410;2018-07-02 19:19:07.007;6430;34;89;55
31;31;2018-06-28 08:12:33.833;2018-07-02 19:19:07.007;6427;34;89;55
31;31;2018-07-05 05:15:49.303;2018-07-05 08:23:11.633;188;34;91;57
31;31;2018-07-10 11:01:20.210;2018-07-10 13:44:35.493;163;34;89;55
31;31;2018-07-10 11:28:02.530;2018-07-10 13:44:35.493;136;34;89;55
31;31;2018-07-10 12:07:55.090;2018-07-10 13:44:35.493;97;34;89;55
31;31;2018-07-11 07:19:00.507;2018-07-11 09:19:50.957;120;34;89;55
31;31;2018-07-22 22:22:10.490;2018-07-23 03:22:11.130;300;13;100;87
35;35;2018-03-20 18:19:26.810;2018-03-20 19:43:34.430;84;31;89;58
35;35;2018-03-21 09:10:09.320;2018-03-21 10:27:32.167;77;33;89;56
31;31;2018-07-24 15:53:36.623;2018-07-24 17:25:28.440;92;34;89;55
35;35;2018-03-22 03:20:42.547;2018-03-22 04:42:43.060;82;33;89;56
31;31;2018-01-29 13:06:33.547;2018-03-21 13:06:05.553;73440;64;92;28
31;31;2018-03-21 10:13:32.573;2018-03-21 13:06:05.553;173;34;92;58
31;31;2018-04-18 08:03:56.240;2018-04-18 09:29:56.670;86;34;85;51
31;31;2018-04-19 23:02:42.420;2018-04-20 00:22:04.053;80;34;89;55
31;31;2018-04-21 02:31:46.587;2018-04-21 03:57:47.573;86;33;89;56
31;31;2018-05-16 11:03:55.857;2018-05-16 12:50:02.283;107;34;89;55
31;31;2018-04-06 19:38:11.010;2018-04-06 21:05:16.453;87;34;89;55
31;31;2018-04-11 04:37:51.253;2018-04-11 07:06:34.573;149;33;88;55
31;31;2018-04-11 07:10:04.417;2018-04-11 07:11:54.227;1;88;93;5
31;31;2018-04-10 07:46:49.137;2018-04-10 10:04:46.573;138;34;89;55
31;31;2018-05-26 09:44:55.747;2018-05-26 11:18:37.647;94;28;89;61
31;31;2018-05-31 14:57:51.643;2018-05-31 15:23:57.843;26;34;35;1
31;31;2018-06-02 09:27:10.603;2018-06-02 12:45:19.127;198;40;92;52
31;31;2018-06-04 13:26:20.807;2018-06-05 19:26:49.937;1800;34;100;66
31;31;2018-06-05 15:20:00.687;2018-06-05 19:26:49.937;246;33;100;67
31;31;2018-06-18 07:08:59.650;2018-06-20 01:29:17.853;2541;34;100;66
31;31;2018-06-19 02:17:05.400;2018-06-20 01:29:17.853;1392;33;100;67
31;31;2018-06-20 18:03:36.653;2018-06-20 19:30:59.680;87;33;89;56
31;31;2018-06-27 14:00:22.517;2018-06-27 15:57:58.187;117;33;89;56
35;35;2017-10-03 09:48:54.113;2017-10-03 10:52:18.023;64;34;89;55
35;35;2017-10-04 00:29:24.070;2017-10-04 01:39:22.363;70;34;89;55
35;35;2017-10-04 03:54:32.187;2017-10-04 12:57:18.270;543;86;89;3
35;35;2017-10-05 01:51:17.287;2017-10-05 02:12:11.620;21;75;89;14
35;35;2017-10-10 07:55:50.020;2017-10-10 09:05:18.560;70;34;89;55
35;35;2017-10-11 14:43:16.890;2017-10-11 15:54:55.190;71;33;89;56
35;35;2017-10-17 10:16:22.827;2017-10-17 11:31:40.243;75;34;89;55
35;35;2017-10-18 04:09:16.167;2017-10-18 05:25:07.370;76;34;89;55
35;35;2017-10-19 13:52:43.177;2017-10-19 14:54:46.127;62;33;79;46
35;35;2017-10-22 21:56:23.977;2017-10-23 02:42:41.883;286;19;100;81
35;35;2017-10-23 21:03:11.433;2017-10-24 10:53:04.957;830;33;89;56
31;31;2018-07-12 08:50:02.523;2018-07-12 10:57:24.310;127;33;89;56
31;31;2018-07-12 08:52:15.290;2018-07-12 10:57:24.310;125;31;89;58
31;31;2018-07-13 10:06:11.207;2018-07-13 12:36:24.390;150;33;89;56
31;31;2018-07-13 10:46:51.633;2018-07-13 12:36:24.390;110;33;89;56
31;31;2018-07-13 10:48:09.807;2018-07-13 12:36:24.390;108;33;89;56
35;35;2017-10-24 09:38:45.770;2017-10-24 10:53:04.957;75;32;89;57
35;35;2017-10-26 12:01:52.827;2017-10-26 13:11:27.087;70;34;89;55
35;35;2017-10-27 05:19:46.063;2017-10-27 06:31:13.330;72;34;89;55
35;35;2017-10-31 09:19:01.230;2017-10-31 10:51:29.387;92;34;89;55
35;35;2017-11-02 16:00:45.630;2017-11-02 17:10:35.310;70;34;89;55
35;35;2017-11-03 13:22:24.257;2017-11-03 14:43:56.787;81;33;89;56
35;35;2017-11-08 11:30:39.817;2017-11-08 11:59:46.407;29;33;58;25
35;35;2017-11-12 22:38:09.760;2017-11-12 23:44:29.760;66;31;89;58
35;35;2017-11-14 07:39:08.427;2017-11-15 11:13:12.060;1654;27;89;62
35;35;2017-11-14 07:45:33.730;2017-11-15 11:13:12.060;1648;23;89;66
35;35;2017-11-14 08:07:19.390;2017-11-15 11:13:12.060;1626;21;89;68
35;35;2017-11-14 08:14:33.470;2017-11-15 11:13:12.060;1619;20;89;69
35;35;2017-11-14 09:58:47.453;2017-11-15 11:13:12.060;1515;20;89;69
35;35;2017-11-17 16:15:54.317;2017-11-17 17:25:59.043;70;29;89;60
35;35;2017-11-18 12:00:57.007;2017-11-18 16:50:24.440;290;64;100;36
35;35;2017-11-20 15:24:17.777;2017-11-20 16:26:36.360;62;34;89;55
31;31;2018-07-31 12:44:35.037;2018-07-31 14:03:00.873;79;33;89;56
34;34;2018-01-11 10:30:58.253;2018-01-11 11:05:23.007;35;33;50;17
34;34;2018-01-11 12:31:49.373;2018-01-11 19:08:55.347;397;48;89;41
34;34;2018-01-11 17:22:41.730;2018-01-11 19:08:55.347;106;33;89;56
34;34;2018-01-17 15:44:56.643;2018-01-17 17:43:34.050;119;30;89;59
34;34;2018-01-25 20:05:12.370;2018-01-25 21:52:20.833;107;34;89;55
34;34;2018-01-31 07:41:58.380;2018-01-31 09:46:34.960;125;34;89;55
35;35;2017-11-29 07:59:56.340;2017-11-29 09:46:41.153;107;33;89;56
31;31;2018-08-04 06:43:58.180;2018-08-04 08:16:31.710;93;33;89;56
34;34;2018-02-16 19:44:24.947;2018-02-16 21:09:55.737;85;34;89;55
34;34;2018-02-22 09:43:08.013;2018-02-22 13:38:39.050;235;34;100;66
34;34;2018-02-21 08:45:40.030;2018-02-22 13:38:39.050;1733;31;100;69
35;35;2017-12-05 05:42:50.537;2017-12-05 07:29:34.697;107;35;89;54
35;35;2017-12-07 05:08:13.070;2017-12-07 06:57:54.707;109;34;89;55
35;35;2017-12-08 04:59:27.790;2017-12-08 06:44:06.013;105;37;89;52
35;35;2017-12-09 12:01:32.287;2017-12-09 17:14:06.170;313;58;100;42
35;35;2017-12-09 12:11:59.050;2017-12-09 17:14:06.170;303;58;100;42
35;35;2017-12-13 02:00:57.220;2017-12-13 03:46:48.180;106;34;89;55
35;35;2017-12-20 10:59:34.413;2017-12-20 12:36:36.763;97;34;86;52
34;34;2018-02-06 17:34:57.890;2018-02-06 19:45:50.557;131;34;89;55
34;34;2018-02-13 17:39:14.270;2018-02-13 19:06:39.990;87;34;89;55
34;34;2018-02-14 10:57:11.343;2018-02-14 12:39:17.133;102;34;89;55
34;34;2018-02-28 07:29:16.590;2018-02-28 08:45:41.347;76;34;89;55
34;34;2018-03-02 09:08:52.033;2018-03-02 10:25:07.663;77;33;89;56
34;34;2018-03-05 15:43:49.970;2018-03-05 16:09:59.790;26;33;48;15
35;35;2017-12-21 08:10:39.043;2017-12-21 10:42:21.307;152;33;70;37
31;31;2018-08-17 05:15:18.380;2018-08-17 06:47:51.093;92;34;89;55
35;35;2017-12-26 11:28:22.670;2017-12-26 15:05:15.083;217;32;89;57
35;35;2017-12-26 12:37:57.343;2017-12-26 15:05:15.083;148;35;89;54
35;35;2018-01-01 22:49:32.960;2018-01-02 00:08:29.090;79;46;89;43
35;35;2018-01-02 11:53:00.087;2018-01-02 13:16:55.330;83;43;89;46
35;35;2018-01-03 20:06:00.813;2018-01-03 21:53:14.070;107;34;89;55
35;35;2018-01-09 20:15:05.687;2018-01-09 21:57:30.070;102;33;89;56
35;35;2018-01-12 08:47:02.800;2018-01-12 10:28:13.860;101;33;89;56
35;35;2018-01-16 07:22:51.107;2018-01-16 08:33:39.473;71;34;72;38
35;35;2018-01-16 07:27:28.700;2018-01-16 08:33:39.473;66;34;72;38
31;31;2018-09-06 10:04:55.457;2018-09-06 12:41:26.280;157;34;89;55
31;31;2018-09-28 11:08:38.547;2018-09-28 12:25:40.280;77;34;85;51
35;35;2018-01-29 02:39:10.130;2018-01-29 04:22:43.713;103;34;89;55
35;35;2018-01-29 02:40:22.870;2018-01-29 04:22:43.713;102;34;89;55
31;31;2018-09-12 07:55:30.957;2018-09-12 09:28:59.920;93;33;89;56
34;34;2018-03-12 15:04:40.030;2018-03-12 16:27:22.143;83;33;89;56
31;31;2018-09-13 07:37:31.660;2018-09-13 09:20:26.207;103;34;89;55
31;31;2018-09-14 06:38:08.677;2018-09-14 08:25:30.367;107;33;89;56
35;35;2018-01-30 08:18:52.477;2018-01-30 09:55:48.570;97;34;89;55
35;35;2018-02-01 14:04:52.200;2018-02-01 15:48:36.460;104;33;89;56
34;34;2018-04-04 14:33:47.463;2018-04-04 17:14:30.053;161;34;89;55
34;34;2018-04-05 11:25:06.110;2018-04-05 14:19:01.320;174;34;89;55
35;35;2018-02-15 13:11:02.883;2018-02-15 14:42:38.320;91;33;89;56
31;31;2018-09-18 13:14:52.920;2018-09-19 11:09:29.453;1315;34;79;45
31;31;2018-09-20 06:44:46.813;2018-09-21 03:07:33.210;1223;34;89;55
35;35;2018-02-22 07:35:59.110;2018-02-22 08:50:06.857;75;33;89;56
35;35;2018-02-26 12:22:01.960;2018-02-26 13:37:04.700;75;34;89;55
31;31;2018-09-25 13:40:26.120;2018-09-25 15:09:37.583;89;33;89;56
31;31;2018-09-26 11:28:32.167;2018-09-26 22:00:12.143;632;34;89;55
35;35;2018-03-13 16:05:07.177;2018-03-13 17:23:03.533;78;34;89;55
34;34;2018-04-06 09:36:00.930;2018-04-06 10:56:12.517;80;33;89;56
31;31;2018-09-27 16:51:42.470;2018-09-27 18:28:39.360;97;34;89;55
35;35;2018-03-15 20:34:39.063;2018-03-15 21:48:48.243;74;34;89;55
31;31;2018-06-12 00:47:55.333;2018-06-12 02:15:11.463;88;34;89;55
31;31;2018-06-12 15:24:10.360;2018-06-12 16:51:18.420;87;33;89;56
31;31;2018-06-15 16:06:25.807;2018-06-15 17:44:04.477;98;33;91;58
31;31;2018-06-28 08:06:00.683;2018-07-02 19:19:07.007;6433;34;89;55
31;31;2018-07-05 05:15:07.093;2018-07-05 08:23:11.633;188;34;91;57
31;31;2018-07-06 07:27:13.790;2018-07-06 08:49:00.160;82;34;89;55
35;35;2018-03-20 05:04:52.383;2018-03-20 06:24:03.503;80;32;89;57
31;31;2018-07-23 21:16:24.753;2018-07-23 22:59:44.647;103;34;89;55
31;31;2018-07-23 21:20:25.687;2018-07-23 22:59:44.647;99;34;89;55
35;35;2018-03-29 12:37:21.543;2018-04-02 00:07:36.303;5010;32;89;57
35;35;2018-04-19 19:04:53.837;2018-04-19 20:39:53.977;95;34;89;55
31;31;2018-07-26 09:25:37.003;2018-07-26 20:41:53.943;676;34;89;55
31;31;2018-07-26 19:05:02.567;2018-07-26 20:41:53.943;96;34;89;55
35;35;2018-02-05 06:01:30.583;2018-02-05 12:42:46.750;401;19;100;81
35;35;2018-02-05 06:03:36.737;2018-02-05 12:42:46.750;399;19;100;81
35;35;2018-02-06 18:47:30.723;2018-02-06 20:48:04.480;121;34;89;55
35;35;2018-02-07 13:51:54.260;2018-02-07 15:50:09.410;119;33;89;56
31;31;2018-07-04 08:25:50.903;2018-07-04 10:52:53.203;147;34;89;55
31;31;2018-07-09 19:30:41.347;2018-07-09 19:41:07.177;11;58;64;6
31;31;2018-07-09 19:41:48.210;2018-07-09 20:20:05.443;39;64;89;25
31;31;2018-07-09 03:17:33.150;2018-07-09 04:51:07.370;94;30;89;59
31;31;2018-07-10 11:38:35.157;2018-07-10 13:44:35.493;126;34;89;55
31;31;2018-07-22 22:20:52.837;2018-07-23 03:22:11.130;302;13;100;87
31;31;2018-07-23 21:17:55.873;2018-07-23 22:59:44.647;102;34;89;55
31;31;2018-07-23 21:21:47.747;2018-07-23 22:59:44.647;98;34;89;55
35;35;2018-03-27 11:55:47.173;2018-03-27 13:14:33.513;79;33;89;56
35;35;2018-03-29 09:41:31.633;2018-04-02 00:07:36.303;5186;33;89;56
34;34;2018-04-11 05:35:29.850;2018-04-11 12:16:36.123;401;33;34;1
34;34;2018-04-11 05:49:01.483;2018-04-11 12:16:36.123;387;33;34;1
31;31;2018-07-25 10:18:36.457;2018-07-25 11:48:00.583;90;34;89;55
31;31;2018-07-26 18:58:45.580;2018-07-26 20:41:53.943;103;34;89;55
35;35;2018-02-05 05:56:21.627;2018-02-05 12:42:46.750;406;19;100;81
35;35;2018-02-05 05:58:55.543;2018-02-05 12:42:46.750;404;19;100;81
35;35;2018-02-05 06:05:37.567;2018-02-05 12:42:46.750;397;19;100;81
35;35;2018-02-05 06:30:38.677;2018-02-05 12:42:46.750;372;17;100;83
35;35;2018-02-08 11:16:48.830;2018-02-08 11:56:25.567;40;68;89;21
35;35;2018-02-09 06:02:04.003;2018-02-09 07:47:52.463;105;34;89;55
35;35;2018-02-12 05:14:47.353;2018-02-12 06:42:52.067;88;33;89;56
35;35;2018-02-12 22:06:35.160;2018-02-12 23:34:01.913;88;34;89;55
34;34;2018-04-11 12:18:58.847;2018-04-11 13:44:45.830;86;34;89;55
34;34;2018-04-16 21:58:41.653;2018-04-16 23:48:30.003;110;34;89;55
34;34;2018-05-06 22:33:29.360;2018-05-06 23:06:48.613;33;25;37;12
31;31;2018-08-08 16:21:07.430;2018-08-08 17:51:45.967;90;33;89;56
35;35;2018-02-27 20:08:08.160;2018-02-27 21:29:13.047;81;33;89;56
35;35;2018-02-27 20:10:58.187;2018-02-27 21:29:13.047;79;33;89;56
34;34;2018-05-07 18:10:45.007;2018-05-07 19:29:07.340;79;33;89;56
31;31;2018-08-10 07:30:29.533;2018-08-10 10:45:43.323;195;34;89;55
31;31;2018-08-10 08:42:14.093;2018-08-10 10:45:43.323;123;34;89;55
34;34;2018-05-09 15:22:18.753;2018-05-09 16:42:05.863;80;34;89;55
35;35;2018-02-28 11:49:38.507;2018-02-28 13:07:09.860;78;34;89;55
35;35;2018-03-01 07:20:48.957;2018-03-01 21:37:23.680;857;85;89;4
31;31;2018-08-13 02:05:00.757;2018-08-14 10:57:41.230;1972;34;100;66
31;31;2018-08-13 05:48:44.033;2018-08-14 10:57:41.230;1749;97;100;3
31;31;2018-08-13 21:13:31.263;2018-08-14 10:57:41.230;824;34;100;66
31;31;2018-08-13 21:22:46.633;2018-08-14 10:57:41.230;815;34;100;66
31;31;2018-08-16 06:16:31.727;2018-08-16 06:44:47.517;28;34;48;14
31;31;2018-08-16 06:17:32.140;2018-08-16 06:44:47.517;27;34;48;14
35;35;2018-03-05 06:47:36.767;2018-03-05 08:06:15.750;79;33;89;56
35;35;2018-03-05 20:07:28.233;2018-03-05 21:25:33.650;78;34;89;55
35;35;2018-03-06 12:53:32.177;2018-03-06 14:13:13.357;80;35;89;54
31;31;2018-08-26 22:08:45.047;2018-08-27 22:59:31.547;1491;48;99;51
35;35;2018-04-02 15:31:31.077;2018-04-02 16:58:01.310;87;34;89;55
35;35;2018-04-03 07:31:28.000;2018-04-03 08:55:04.770;84;34;89;55
31;31;2018-09-03 05:04:15.403;2018-09-03 06:07:30.557;63;34;67;33
35;35;2018-04-11 09:24:24.480;2018-04-11 10:50:47.033;86;34;89;55
32;32;2018-09-05 09:32:36.040;2018-09-05 10:46:51.487;74;33;87;54
32;32;2018-09-03 18:11:41.470;2018-09-03 21:40:44.657;209;33;89;56
32;32;2018-08-31 06:58:04.017;2018-08-31 08:21:50.007;83;33;89;56
34;34;2018-05-14 11:50:57.727;2018-05-14 13:13:02.923;83;34;89;55
32;32;2018-08-30 14:27:47.450;2018-08-30 16:21:57.790;114;33;89;56
35;35;2018-05-15 14:15:48.717;2018-05-15 15:32:44.583;77;34;89;55
32;32;2018-08-30 00:13:56.667;2018-08-30 01:56:21.487;103;31;89;58
35;35;2018-05-23 18:29:41.723;2018-05-23 19:48:31.177;79;34;89;55
35;35;2018-06-07 08:26:25.790;2018-06-07 11:05:22.967;159;34;89;55
35;35;2018-06-07 08:27:31.113;2018-06-07 11:05:22.967;158;34;89;55
35;35;2018-06-07 09:09:12.773;2018-06-07 11:05:22.967;116;34;89;55
35;35;2018-06-08 22:45:04.863;2018-06-09 00:19:20.997;94;33;89;56
34;34;2018-05-26 11:48:02.707;2018-05-26 13:11:36.340;83;36;89;53
34;34;2018-05-28 22:57:33.703;2018-05-29 00:20:13.613;83;33;89;56
34;34;2018-05-29 00:38:23.813;2018-05-29 00:41:00.817;3;88;89;1
35;35;2018-06-10 22:31:58.093;2018-06-11 03:56:51.847;325;43;100;57
32;32;2018-08-27 22:59:58.270;2018-08-28 02:30:23.543;211;33;89;56
32;32;2018-08-27 23:25:36.133;2018-08-28 02:30:23.543;185;33;89;56
32;32;2018-08-28 00:47:46.500;2018-08-28 02:30:23.543;103;33;89;56
34;34;2018-05-31 08:47:13.970;2018-05-31 10:27:53.313;100;34;89;55
34;34;2018-06-01 15:08:01.970;2018-06-01 17:12:16.877;124;34;89;55
32;32;2018-08-13 05:56:56.963;2018-08-13 10:21:56.193;265;15;99;84
35;35;2018-06-12 13:33:21.070;2018-06-12 14:55:03.683;82;34;89;55
34;34;2018-06-04 05:40:18.200;2018-06-04 07:02:46.850;82;32;89;57
34;34;2018-02-27 16:10:25.157;2018-02-27 17:24:21.867;74;34;89;55
34;34;2018-03-14 17:04:02.143;2018-03-14 18:36:32.730;92;31;89;58
35;35;2018-06-18 10:22:36.237;2018-06-18 11:48:26.647;86;34;92;58
32;32;2018-08-08 22:41:56.930;2018-08-09 00:10:35.767;89;34;89;55
35;35;2018-07-05 09:23:41.677;2018-07-06 06:41:41.703;1278;87;89;2
32;32;2018-07-24 08:25:12.970;2018-07-24 12:47:01.893;262;29;89;60
34;34;2018-03-16 15:11:04.890;2018-03-16 16:37:45.250;86;33;89;56
32;32;2018-07-26 11:08:25.893;2018-07-26 12:23:46.967;75;34;89;55
34;34;2018-03-27 05:57:27.663;2018-03-27 07:53:58.007;116;34;89;55
34;34;2018-03-28 05:52:54.223;2018-03-28 07:45:27.160;113;33;89;56
34;34;2018-03-28 05:54:45.540;2018-03-28 07:45:27.160;111;33;89;56
35;35;2018-07-11 07:12:15.423;2018-07-11 07:50:25.773;38;34;59;25
34;34;2018-04-01 22:13:17.240;2018-04-02 00:31:02.960;138;30;89;59
35;35;2018-07-23 07:28:31.557;2018-07-23 09:23:04.100;115;34;89;55
35;35;2018-07-23 07:54:14.030;2018-07-23 09:23:04.100;89;34;89;55
35;35;2018-07-23 08:06:38.937;2018-07-23 09:23:04.100;77;34;89;55
35;35;2018-07-23 20:27:56.060;2018-07-23 21:44:22.100;77;34;89;55
35;35;2018-07-24 11:35:26.863;2018-07-24 12:51:17.700;76;32;89;57
34;34;2018-04-24 19:11:09.050;2018-04-25 02:44:26.060;453;34;89;55
34;34;2018-04-24 19:33:49.560;2018-04-25 02:44:26.060;431;34;89;55
34;34;2018-04-24 19:38:45.910;2018-04-25 02:44:26.060;426;34;89;55
34;34;2018-04-25 20:42:58.573;2018-04-25 22:04:05.337;82;34;89;55
35;35;2018-07-30 09:10:34.953;2018-07-30 10:27:39.980;77;34;89;55
35;35;2018-08-08 18:52:37.610;2018-08-08 20:42:03.923;110;34;89;55
34;34;2018-05-01 22:34:32.763;2018-05-02 00:04:19.447;90;31;89;58
34;34;2018-05-16 09:24:54.737;2018-05-16 11:07:33.790;103;34;89;55
35;35;2018-05-07 23:49:06.687;2018-05-08 01:37:55.717;108;34;89;55
35;35;2018-05-10 10:30:49.743;2018-05-10 12:23:58.107;113;33;89;56
34;34;2018-05-18 01:31:28.067;2018-05-18 03:34:29.980;123;27;89;62
34;34;2018-05-18 01:47:22.557;2018-05-18 03:34:29.980;107;27;89;62
34;34;2018-05-18 01:51:25.847;2018-05-18 03:34:29.980;103;27;89;62
34;34;2018-05-22 02:00:42.030;2018-05-22 03:26:32.770;86;34;89;55
32;32;2018-07-10 18:29:09.557;2018-07-10 19:43:56.010;74;34;89;55
32;32;2018-07-09 12:37:30.880;2018-07-09 13:48:58.357;71;34;89;55
35;35;2018-05-11 10:05:29.777;2018-05-11 12:04:54.157;119;33;89;56
35;35;2018-05-14 07:14:20.697;2018-05-14 09:24:39.763;130;34;93;59
34;34;2018-05-25 04:57:30.733;2018-05-25 06:57:26.513;120;34;89;55
34;34;2018-05-25 04:58:45.503;2018-05-25 06:57:26.513;119;34;89;55
34;34;2018-05-25 05:03:08.673;2018-05-25 06:57:26.513;114;34;89;55
35;35;2018-05-29 00:34:02.050;2018-05-29 01:56:40.537;82;33;89;56
32;32;2018-06-18 07:12:42.723;2018-06-18 08:28:00.120;76;31;89;58
32;32;2018-06-18 07:02:14.433;2018-06-18 08:28:00.120;86;32;89;57
32;32;2018-06-17 22:28:01.730;2018-06-18 08:28:00.120;600;44;89;45
32;32;2018-06-14 02:54:55.030;2018-06-14 04:23:22.757;89;33;89;56
35;35;2018-06-01 05:23:43.927;2018-06-01 06:39:57.133;76;33;89;56
35;35;2018-06-03 21:59:21.420;2018-06-04 03:22:52.240;323;49;100;51
32;32;2018-06-07 18:43:41.220;2018-06-07 20:05:24.337;82;33;89;56
35;35;2018-06-19 05:38:22.517;2018-06-19 06:51:46.980;73;33;89;56
35;35;2018-06-19 20:32:33.723;2018-06-19 21:44:36.993;72;34;89;55
35;35;2018-06-20 11:25:38.943;2018-06-20 19:57:50.487;512;33;89;56
34;34;2018-07-03 21:38:55.593;2018-07-03 23:24:47.977;106;34;89;55
34;34;2018-07-08 22:38:00.970;2018-07-09 17:07:20.137;1109;27;100;73
34;34;2018-07-08 22:43:20.637;2018-07-09 17:07:20.137;1104;27;100;73
34;34;2018-07-08 22:46:01.150;2018-07-09 17:07:20.137;1101;27;100;73
35;35;2018-06-25 23:51:41.023;2018-06-26 01:09:09.083;78;32;89;57
31;31;2018-09-26 11:44:42.670;2018-09-26 22:00:12.143;616;32;89;57
31;31;2018-05-24 11:07:43.543;2018-05-24 12:46:52.250;99;34;89;55
31;31;2018-05-24 11:13:10.323;2018-05-24 12:46:52.250;93;34;89;55
35;35;2018-03-19 07:32:25.250;2018-03-19 08:48:30.580;76;33;89;56
31;31;2018-06-07 09:42:50.733;2018-06-07 11:18:12.270;96;32;89;57
31;31;2018-06-11 01:35:09.930;2018-06-11 04:53:04.780;198;17;100;83
31;31;2018-06-11 02:51:35.750;2018-06-11 04:53:04.780;122;27;100;73
31;31;2018-06-14 04:29:39.563;2018-06-14 05:59:09.793;90;34;89;55
31;31;2018-07-02 17:26:38.563;2018-07-02 19:19:07.007;113;33;89;56
31;31;2018-07-03 13:14:29.210;2018-07-03 15:19:29.913;125;34;89;55
31;31;2018-07-09 18:36:50.630;2018-07-09 19:30:36.443;54;34;58;24
31;31;2018-07-06 07:18:21.527;2018-07-06 08:49:00.160;91;34;89;55
31;31;2018-07-10 12:06:56.003;2018-07-10 13:44:35.493;98;34;89;55
31;31;2018-07-11 07:50:57.160;2018-07-11 09:19:50.957;89;34;89;55
31;31;2018-07-23 21:32:25.207;2018-07-23 22:59:44.647;87;34;89;55
35;35;2018-04-01 22:11:14.307;2018-04-02 00:07:36.303;116;17;89;72
35;35;2018-04-17 17:38:42.363;2018-04-17 19:10:19.510;92;34;89;55
35;35;2018-04-18 11:52:28.790;2018-04-18 13:24:53.053;92;34;89;55
35;35;2018-04-20 16:16:39.700;2018-04-20 17:49:48.063;93;34;89;55
35;35;2018-02-05 06:08:36.077;2018-02-05 12:42:46.750;394;18;100;82
31;31;2018-07-26 19:00:11.620;2018-07-26 20:41:53.943;101;34;89;55
31;31;2018-07-30 14:26:40.810;2018-07-30 15:52:11.363;86;33;89;56
31;31;2018-07-27 19:11:38.507;2018-07-27 20:44:59.350;93;34;92;58
35;35;2018-02-06 19:00:58.190;2018-02-06 20:48:04.480;108;34;89;55
35;35;2018-02-12 22:08:26.373;2018-02-12 23:34:01.913;86;34;89;55
34;34;2018-04-13 06:33:48.040;2018-04-13 08:06:58.227;93;33;89;56
34;34;2018-04-13 20:30:33.403;2018-04-13 22:01:45.767;91;34;89;55
35;35;2018-02-14 12:01:41.927;2018-02-14 13:18:28.320;77;33;84;51
35;35;2018-02-27 20:14:25.697;2018-02-27 21:29:13.047;75;33;89;56
34;34;2018-05-06 23:11:45.160;2018-05-07 00:30:07.503;79;37;89;52
35;35;2018-03-01 03:02:30.327;2018-03-01 04:20:53.247;78;33;89;56
35;35;2018-03-01 20:22:47.403;2018-03-01 21:37:23.680;75;36;89;53
35;35;2018-03-05 06:38:16.160;2018-03-05 08:06:15.750;88;33;89;56
35;35;2018-03-05 06:49:48.120;2018-03-05 08:06:15.750;77;33;89;56
31;31;2018-08-14 06:09:47.870;2018-08-14 10:57:41.230;288;30;100;70
34;34;2018-05-11 02:32:01.050;2018-05-11 03:58:57.877;86;32;89;57
35;35;2018-03-05 20:03:45.920;2018-03-05 21:25:33.650;82;34;89;55
31;31;2018-08-28 20:35:10.860;2018-08-29 12:36:52.673;961;30;100;70
31;31;2018-08-29 08:40:11.447;2018-08-29 12:36:52.673;236;30;100;70
34;34;2018-05-11 17:10:06.880;2018-05-11 18:32:50.260;82;33;89;56
31;31;2018-08-31 08:51:49.617;2018-08-31 10:32:18.720;101;30;89;59
35;35;2018-04-12 06:53:43.437;2018-04-12 08:20:04.520;87;33;89;56
31;31;2018-09-04 22:44:45.843;2018-09-05 00:21:11.010;97;33;89;56
32;32;2018-09-05 09:30:20.487;2018-09-05 10:46:51.487;76;33;87;54
32;32;2018-09-04 12:22:27.843;2018-09-04 13:37:44.650;75;34;89;55
32;32;2018-09-03 16:59:55.947;2018-09-03 21:40:44.657;281;33;89;56
32;32;2018-09-03 20:03:11.767;2018-09-03 21:40:44.657;97;33;89;56
35;35;2018-04-30 09:05:08.330;2018-04-30 10:39:39.080;94;33;89;56
35;35;2018-04-30 09:06:23.683;2018-04-30 10:39:39.080;93;33;89;56
32;32;2018-08-30 14:20:06.883;2018-08-30 16:21:57.790;121;33;89;56
32;32;2018-08-30 14:21:43.010;2018-08-30 16:21:57.790;120;33;89;56
32;32;2018-08-30 15:05:47.953;2018-08-30 16:21:57.790;76;33;89;56
35;35;2018-05-02 07:09:19.060;2018-05-02 08:46:22.760;97;33;89;56
32;32;2018-08-28 15:37:13.480;2018-08-28 17:47:17.020;130;34;89;55
32;32;2018-08-28 16:35:50.250;2018-08-28 17:47:17.020;72;34;89;55
32;32;2018-08-28 16:17:50.360;2018-08-28 17:47:17.020;90;34;89;55
35;35;2018-05-16 07:32:55.087;2018-05-16 08:51:48.620;79;34;89;55
35;35;2018-05-17 16:55:32.647;2018-05-17 18:13:41.367;78;33;89;56
35;35;2018-05-22 02:56:34.333;2018-05-22 04:24:30.660;88;31;89;58
35;35;2018-05-24 13:22:34.373;2018-05-24 14:41:26.980;79;34;89;55
32;32;2018-08-27 20:09:17.913;2018-08-28 02:30:23.543;381;33;89;56
32;32;2018-08-27 23:00:57.590;2018-08-28 02:30:23.543;210;33;89;56
32;32;2018-08-27 23:24:17.587;2018-08-28 02:30:23.543;186;33;89;56
35;35;2018-06-07 08:23:39.040;2018-06-07 11:05:22.967;162;34;89;55
35;35;2018-06-07 09:09:54.090;2018-06-07 11:05:22.967;116;34;89;55
34;34;2018-05-29 00:39:42.170;2018-05-29 00:41:00.817;2;88;89;1
34;34;2018-05-31 08:50:21.367;2018-05-31 10:27:53.313;97;34;89;55
34;34;2018-06-01 15:07:02.213;2018-06-01 17:12:16.877;125;34;89;55
32;32;2018-08-13 01:47:36.667;2018-08-13 10:21:56.193;514;15;99;84
35;35;2018-06-14 01:28:21.017;2018-06-14 02:49:42.957;81;34;89;55
35;35;2018-06-15 12:29:30.863;2018-06-15 13:54:37.250;85;34;89;55
32;32;2018-07-28 02:55:44.833;2018-07-28 04:16:06.120;81;32;89;57
32;32;2018-08-08 12:20:19.977;2018-08-08 22:31:18.537;611;33;34;1
35;35;2018-07-03 08:15:46.080;2018-07-03 09:30:36.540;75;33;89;56
32;32;2018-07-30 14:40:00.213;2018-07-30 15:54:27.700;74;34;89;55
35;35;2018-07-05 08:04:44.653;2018-07-05 09:23:32.427;79;32;87;55
34;34;2018-03-15 22:45:08.783;2018-03-16 00:18:01.940;93;33;89;56
35;35;2018-07-06 21:08:43.143;2018-07-06 21:24:35.153;16;79;89;10
35;35;2018-07-07 20:01:27.987;2018-07-08 01:30:14.447;329;54;100;46
35;35;2018-07-10 12:23:28.820;2018-07-10 13:52:57.620;89;34;89;55
34;34;2018-04-01 22:13:56.367;2018-04-02 00:31:02.960;138;30;89;59
34;34;2018-04-18 19:33:00.110;2018-04-18 20:50:06.787;77;34;89;55
35;35;2018-07-23 07:59:56.600;2018-07-23 09:23:04.100;84;34;89;55
34;34;2018-04-20 19:59:06.453;2018-04-20 21:19:28.080;80;33;89;56
35;35;2018-07-23 20:26:16.257;2018-07-23 21:44:22.100;78;34;89;55
35;35;2018-07-25 03:32:02.240;2018-07-25 04:50:02.727;78;34;89;55
34;34;2018-04-24 08:38:47.090;2018-04-24 09:56:07.327;78;33;89;56
34;34;2018-04-27 07:35:23.483;2018-04-27 08:56:33.223;81;34;89;55
32;32;2018-07-23 08:00:00.647;2018-07-23 08:15:58.080;15;34;40;6
34;34;2018-05-17 04:43:57.623;2018-05-17 06:07:55.347;84;34;89;55
34;34;2018-05-18 01:49:14.757;2018-05-18 03:34:29.980;105;27;89;62
34;34;2018-05-18 01:52:59.433;2018-05-18 03:34:29.980;102;27;89;62
34;34;2018-05-18 01:54:05.117;2018-05-18 03:34:29.980;100;27;89;62
32;32;2018-07-06 22:31:14.690;2018-07-06 23:45:01.897;74;33;89;56
32;32;2018-07-10 06:55:01.160;2018-07-10 08:21:50.087;86;33;89;56
32;32;2018-07-02 15:44:21.790;2018-07-02 16:54:48.687;70;34;89;55
32;32;2018-07-02 15:45:12.873;2018-07-02 16:54:48.687;69;34;89;55
34;34;2018-05-25 05:24:09.323;2018-05-25 06:57:26.513;93;34;89;55
35;35;2018-05-27 22:11:48.710;2018-05-28 04:01:01.420;350;44;100;56
32;32;2018-06-14 21:35:39.870;2018-06-14 22:48:43.243;73;34;89;55
32;32;2018-06-15 13:21:18.277;2018-06-15 14:39:39.020;78;33;89;56
35;35;2018-05-31 10:52:49.877;2018-05-31 12:05:13.687;73;34;89;55
32;32;2018-06-13 08:27:09.763;2018-06-13 09:52:27.223;85;33;89;56
34;34;2018-06-06 19:17:48.907;2018-06-06 20:40:41.280;83;33;89;56
35;35;2018-06-04 19:44:13.143;2018-06-04 21:07:24.307;83;33;89;56
35;35;2018-06-05 12:24:59.460;2018-06-05 14:51:04.820;147;34;89;55
35;35;2018-06-05 12:25:56.690;2018-06-05 14:51:04.820;146;34;89;55
35;35;2018-06-20 11:27:19.823;2018-06-20 19:57:50.487;510;33;89;56
32;32;2018-09-28 02:54:03.860;2018-09-28 04:31:08.063;97;34;89;55
35;35;2018-06-22 08:37:23.617;2018-06-22 09:54:09.677;77;32;89;57
32;32;2018-09-27 08:18:18.843;2018-09-27 09:35:25.130;77;33;82;49
34;34;2018-07-08 22:39:26.943;2018-07-09 17:07:20.137;1108;27;100;73
32;32;2018-09-26 12:44:29.253;2018-09-26 14:14:36.673;90;34;89;55
32;32;2018-09-24 21:09:59.930;2018-09-24 21:43:34.933;34;34;55;21
32;32;2018-09-25 06:34:44.587;2018-09-25 07:58:22.310;84;33;89;56
35;35;2018-07-17 09:12:34.680;2018-07-17 11:03:39.777;111;34;89;55
35;35;2018-07-18 05:40:05.810;2018-07-18 08:19:46.353;159;33;89;56
32;32;2018-09-22 14:02:19.563;2018-09-22 19:52:47.660;350;35;100;65
34;34;2018-07-11 00:01:32.417;2018-07-11 01:25:00.870;84;33;89;56
35;35;2018-08-01 09:49:34.370;2018-08-01 11:08:13.653;79;33;89;56
34;34;2018-07-11 15:02:08.327;2018-07-11 16:24:32.317;82;34;89;55
32;32;2018-09-17 12:32:51.900;2018-09-17 13:57:37.830;85;34;89;55
34;34;2018-07-21 01:27:50.780;2018-07-23 10:59:50.580;3452;32;89;57
32;32;2018-09-14 16:01:34.513;2018-09-14 17:27:19.307;86;33;89;56
32;32;2018-09-11 10:51:16.040;2018-09-11 16:36:46.770;345;33;89;56
34;34;2018-07-25 09:18:57.113;2018-07-26 00:24:12.240;906;88;89;1
32;32;2018-09-10 15:19:22.303;2018-09-10 16:45:53.123;86;34;89;55
35;35;2018-04-24 09:15:52.020;2018-04-24 10:50:22.163;95;33;89;56
34;34;2018-04-08 22:55:21.657;2018-04-09 03:53:14.950;298;39;100;61
34;34;2018-04-10 11:44:09.690;2018-04-10 13:10:16.367;86;34;89;55
34;34;2018-04-10 11:47:54.150;2018-04-10 13:10:16.367;83;34;89;55
34;34;2018-04-09 18:00:50.440;2018-04-09 19:41:19.363;101;34;89;55
35;35;2018-04-19 05:34:01.467;2018-04-19 07:06:31.567;92;33;89;56
31;31;2018-07-30 13:58:04.907;2018-07-30 15:52:11.363;114;33;89;56
35;35;2018-02-05 06:24:13.487;2018-02-05 12:42:46.750;378;17;100;83
35;35;2018-02-06 09:50:39.070;2018-02-06 11:06:13.710;76;32;71;39
35;35;2018-02-08 09:31:04.377;2018-02-08 10:40:25.740;69;34;69;35
35;35;2018-02-12 22:04:42.897;2018-02-12 23:34:01.913;90;34;89;55
34;34;2018-04-12 10:56:44.347;2018-04-12 12:27:59.543;91;33;86;53
31;31;2018-08-07 21:42:28.353;2018-08-07 23:11:07.040;89;34;89;55
34;34;2018-05-03 12:29:02.590;2018-05-03 14:25:49.587;116;17;89;72
34;34;2018-05-04 04:25:34.000;2018-05-04 05:56:22.673;91;33;89;56
35;35;2018-02-13 17:32:11.510;2018-02-13 19:07:26.927;95;34;89;55
35;35;2018-02-13 17:39:25.147;2018-02-13 19:07:26.927;88;34;89;55
35;35;2018-02-14 12:02:28.910;2018-02-14 13:18:28.320;76;33;84;51
34;34;2018-05-07 18:09:11.123;2018-05-07 19:29:07.340;80;33;89;56
34;34;2018-05-09 07:22:23.577;2018-05-09 16:42:05.863;560;33;89;56
34;34;2018-05-10 11:02:10.487;2018-05-10 12:20:28.613;78;34;89;55
35;35;2018-04-04 12:45:39.300;2018-04-04 14:09:23.417;84;34;89;55
35;35;2018-04-05 12:46:14.197;2018-04-05 14:11:21.863;85;34;89;55
35;35;2018-04-10 12:34:50.750;2018-04-10 14:02:05.873;88;34;89;55
31;31;2018-08-28 20:52:12.737;2018-08-29 12:36:52.673;944;30;100;70
31;31;2018-08-30 08:31:31.843;2018-08-30 10:01:24.367;90;34;89;55
31;31;2018-08-31 08:50:16.413;2018-08-31 10:32:18.720;102;31;89;58
31;31;2018-09-04 02:14:58.657;2018-09-04 03:25:34.643;71;53;89;36
35;35;2018-04-13 01:36:17.843;2018-04-13 03:03:18.017;87;34;89;55
35;35;2018-04-16 10:52:43.343;2018-04-16 12:37:08.817;105;34;89;55
35;35;2018-05-04 03:17:02.257;2018-05-04 05:05:08.927;108;31;89;58
32;32;2018-09-05 06:58:43.820;2018-09-05 10:46:51.487;228;33;87;54
35;35;2018-05-04 19:46:46.843;2018-05-04 20:54:28.690;68;33;72;39
35;35;2018-04-24 21:42:27.193;2018-04-24 23:18:58.193;96;33;89;56
35;35;2018-04-27 17:52:56.120;2018-04-27 19:21:35.053;89;33;89;56
34;34;2018-05-26 02:49:20.377;2018-05-26 11:05:56.460;496;30;33;3
32;32;2018-08-30 14:23:20.167;2018-08-30 16:21:57.790;118;33;89;56
32;32;2018-08-30 00:31:43.903;2018-08-30 01:56:21.487;85;31;89;58
34;34;2018-05-26 11:44:56.490;2018-05-26 11:46:46.167;2;35;36;1
34;34;2018-05-27 22:11:21.000;2018-05-28 03:43:06.587;332;44;100;56
32;32;2018-08-27 20:10:43.090;2018-08-28 02:30:23.543;380;33;89;56
32;32;2018-08-27 20:36:14.157;2018-08-28 02:30:23.543;354;33;89;56
32;32;2018-08-27 23:23:31.487;2018-08-28 02:30:23.543;187;33;89;56
34;34;2018-05-29 20:24:42.007;2018-05-29 21:49:23.940;85;34;89;55
34;34;2018-05-30 12:09:20.547;2018-05-30 13:36:02.780;87;34;89;55
34;34;2018-05-31 08:50:31.737;2018-05-31 10:27:53.313;97;34;89;55
34;34;2018-06-01 02:17:54.167;2018-06-01 03:35:42.707;78;33;89;56
32;32;2018-08-14 01:33:44.920;2018-08-14 03:58:16.680;145;33;96;63
32;32;2018-08-13 01:39:53.487;2018-08-13 10:21:56.193;522;15;99;84
32;32;2018-08-09 17:24:07.063;2018-08-09 18:47:37.793;83;34;89;55
32;32;2018-08-08 11:41:34.057;2018-08-08 22:31:18.537;650;33;34;1
35;35;2018-07-05 07:59:45.317;2018-07-05 09:23:32.427;84;32;87;55
35;35;2018-07-06 05:24:14.643;2018-07-06 06:41:41.703;77;34;89;55
35;35;2018-07-06 20:05:41.063;2018-07-06 21:08:36.680;63;32;79;47
32;32;2018-07-25 20:16:28.283;2018-07-25 21:27:40.327;71;34;89;55
32;32;2018-07-24 08:24:28.730;2018-07-24 12:47:01.893;263;29;89;60
32;32;2018-07-24 08:26:06.433;2018-07-24 12:47:01.893;261;29;89;60
32;32;2018-07-24 11:32:47.903;2018-07-24 12:47:01.893;75;33;89;56
32;32;2018-07-24 11:34:07.787;2018-07-24 12:47:01.893;73;33;89;56
34;34;2018-03-19 10:30:59.480;2018-03-19 11:55:07.040;85;34;89;55
34;34;2018-03-20 05:48:54.900;2018-03-20 07:38:27.383;110;34;89;55
34;34;2018-03-20 20:44:25.337;2018-03-20 21:36:01.220;52;33;43;10
34;34;2018-03-20 20:54:05.830;2018-03-20 21:36:01.220;42;33;43;10
35;35;2018-07-09 19:42:16.503;2018-07-09 21:07:07.960;85;34;89;55
34;34;2018-03-22 23:38:37.450;2018-03-23 01:26:56.843;108;33;89;56
34;34;2018-03-30 06:55:56.143;2018-04-02 00:31:02.960;3936;33;89;56
35;35;2018-07-10 12:25:38.500;2018-07-10 13:52:57.620;87;34;89;55
35;35;2018-07-10 12:26:47.977;2018-07-10 13:52:57.620;86;34;89;55
34;34;2018-04-17 13:50:13.603;2018-04-17 15:30:19.807;100;34;93;59
34;34;2018-04-20 04:25:05.543;2018-04-20 05:43:07.053;78;33;89;56
34;34;2018-04-24 19:31:21.583;2018-04-25 02:44:26.060;433;34;89;55
34;34;2018-04-25 01:22:09.983;2018-04-25 02:44:26.060;82;34;89;55
34;34;2018-04-25 01:24:45.327;2018-04-25 02:44:26.060;80;34;89;55
35;35;2018-07-26 17:36:15.320;2018-07-26 18:50:51.320;74;34;89;55
34;34;2018-04-26 12:34:58.397;2018-04-26 13:55:08.240;81;34;89;55
34;34;2018-04-28 00:24:02.360;2018-04-28 01:46:41.460;82;33;89;56
34;34;2018-04-30 07:14:28.937;2018-04-30 12:59:58.577;345;33;100;67
35;35;2018-05-08 18:09:58.807;2018-05-08 19:57:53.543;108;34;89;55
34;34;2018-05-16 06:20:53.410;2018-05-16 11:07:33.790;287;29;89;60
34;34;2018-05-16 09:20:54.230;2018-05-16 11:07:33.790;107;34;89;55
34;34;2018-05-16 09:40:50.260;2018-05-16 11:07:33.790;87;34;89;55
34;34;2018-05-16 09:42:36.227;2018-05-16 11:07:33.790;85;34;89;55
32;32;2018-07-23 08:17:56.860;2018-07-23 09:44:52.963;87;40;91;51
34;34;2018-05-18 07:02:11.063;2018-05-18 07:07:44.790;5;85;89;4
35;35;2018-05-09 12:10:47.557;2018-05-09 14:03:56.947;113;33;89;56
34;34;2018-05-22 16:41:30.583;2018-05-22 18:10:44.003;89;34;89;55
34;34;2018-05-23 11:45:10.780;2018-05-23 13:13:22.377;88;33;89;56
35;35;2018-05-26 03:09:36.103;2018-05-26 04:36:42.890;87;30;89;59
35;35;2018-05-14 23:43:21.640;2018-05-15 01:00:02.190;77;33;89;56
34;34;2018-05-24 10:06:22.493;2018-05-24 11:36:00.707;90;34;89;55
34;34;2018-05-25 04:54:54.827;2018-05-25 06:57:26.513;123;34;89;55
35;35;2018-05-29 20:23:15.400;2018-05-29 21:45:04.030;82;34;89;55
35;35;2018-05-30 12:50:17.500;2018-05-30 13:56:31.963;66;34;58;24
35;35;2018-05-31 10:36:44.450;2018-05-31 12:05:13.687;89;34;89;55
32;32;2018-09-20 16:34:00.073;2018-09-20 18:05:35.410;91;34;89;55
34;34;2018-06-06 06:23:02.587;2018-06-06 07:58:14.250;95;33;89;56
35;35;2018-06-02 09:22:57.120;2018-06-02 10:47:04.030;85;31;89;58
32;32;2018-06-09 14:01:31.137;2018-06-09 19:09:11.937;308;48;100;52
35;35;2018-06-20 18:44:08.460;2018-06-20 19:57:50.487;73;33;89;56
35;35;2018-06-21 12:56:39.067;2018-06-21 14:11:25.730;75;33;89;56
32;32;2018-09-28 01:50:56.030;2018-09-28 04:31:08.063;161;34;89;55
35;35;2018-06-24 22:41:17.903;2018-06-25 00:03:26.777;82;31;89;58
35;35;2018-06-25 23:49:39.380;2018-06-26 01:09:09.083;80;32;89;57
34;34;2018-07-08 22:03:35.817;2018-07-09 17:07:20.137;1144;18;100;82
34;34;2018-07-09 13:55:46.337;2018-07-09 17:07:20.137;192;33;100;67
34;34;2018-07-10 14:07:08.460;2018-07-11 01:25:00.870;678;57;89;32
35;35;2018-06-27 07:42:24.243;2018-06-27 08:56:36.500;74;34;89;55
35;35;2018-06-28 08:50:14.327;2018-06-28 09:14:02.587;24;34;52;18
35;35;2018-06-28 14:41:41.790;2018-06-28 16:00:58.740;79;31;89;58
35;35;2018-07-12 08:48:36.833;2018-07-12 15:06:37.423;378;34;89;55
35;35;2018-07-12 13:38:15.073;2018-07-12 15:06:37.423;88;34;89;55
35;35;2018-07-19 21:35:57.957;2018-07-19 23:10:33.533;95;32;93;61
32;32;2018-09-21 08:43:50.043;2018-09-21 10:17:16.167;94;34;89;55
35;35;2018-07-31 00:03:30.133;2018-07-31 01:20:32.417;77;34;89;55
32;32;2018-09-13 02:04:59.647;2018-09-13 03:27:17.430;83;33;89;56
35;35;2018-08-02 21:29:44.427;2018-08-02 22:48:33.637;79;34;89;55
35;35;2018-08-03 12:05:19.263;2018-08-03 13:22:02.010;77;34;89;55
35;35;2018-08-05 23:57:12.293;2018-08-06 01:16:05.947;79;33;89;56
35;35;2018-08-06 13:32:47.397;2018-08-06 19:55:20.507;383;34;89;55
35;35;2018-08-06 18:33:33.567;2018-08-06 19:55:20.507;82;33;89;56
32;32;2018-09-12 09:07:10.033;2018-09-12 10:29:05.320;82;34;89;55
32;32;2018-09-11 10:34:33.730;2018-09-11 16:36:46.770;362;33;89;56
32;32;2018-09-11 10:50:35.117;2018-09-11 16:36:46.770;346;33;89;56
34;34;2018-07-25 22:46:23.203;2018-07-26 00:24:12.240;98;34;89;55
35;35;2018-08-17 05:17:15.673;2018-08-17 06:45:42.970;88;34;89;55
35;35;2018-08-20 15:28:59.700;2018-08-20 16:59:30.690;91;34;89;55
34;34;2018-07-26 15:21:08.470;2018-07-26 16:42:55.880;81;34;89;55
34;34;2018-04-12 12:31:18.967;2018-04-13 08:06:58.227;1175;86;89;3
34;34;2018-04-16 09:11:45.850;2018-04-16 10:51:34.160;100;34;89;55
34;34;2018-04-16 22:07:00.580;2018-04-16 23:48:30.003;101;34;89;55
31;31;2018-08-09 13:51:24.010;2018-08-09 15:24:32.453;93;33;89;56
31;31;2018-08-10 09:08:56.803;2018-08-10 10:45:43.323;97;34;89;55
34;34;2018-05-08 14:01:11.840;2018-05-08 15:18:43.550;77;33;89;56
35;35;2018-03-02 15:02:49.550;2018-03-02 16:20:22.003;78;34;89;55
31;31;2018-08-13 02:08:54.227;2018-08-14 10:57:41.230;1969;34;100;66
31;31;2018-08-13 21:21:35.620;2018-08-14 10:57:41.230;816;34;100;66
31;31;2018-08-27 20:09:26.473;2018-08-27 22:59:31.547;170;33;99;66
35;35;2018-03-07 11:52:34.980;2018-03-07 13:00:03.663;68;33;80;47
35;35;2018-03-07 13:03:46.707;2018-03-07 13:17:06.050;14;80;89;9
34;34;2018-05-11 02:23:54.120;2018-05-11 03:58:57.877;95;32;89;57
35;35;2018-03-12 21:06:07.330;2018-03-12 22:29:31.473;83;34;89;55
31;31;2018-08-30 08:29:44.117;2018-08-30 10:01:24.367;92;34;89;55
31;31;2018-08-31 06:11:57.053;2018-08-31 10:32:18.720;261;32;89;57
31;31;2018-08-31 06:12:37.367;2018-08-31 10:32:18.720;260;32;89;57
31;31;2018-09-03 13:31:36.203;2018-09-03 15:06:13.153;95;34;89;55
35;35;2018-04-13 17:12:43.610;2018-04-13 18:40:33.987;88;34;89;55
35;35;2018-04-16 11:01:06.450;2018-04-16 12:37:08.817;96;34;89;55
35;35;2018-04-17 04:40:46.593;2018-04-17 06:10:50.757;90;34;89;55
31;31;2018-09-05 15:57:09.107;2018-09-05 17:21:42.107;84;33;89;56
32;32;2018-09-03 02:49:34.313;2018-09-03 04:08:09.493;79;31;89;58
35;35;2018-05-03 06:21:02.240;2018-05-03 08:00:54.247;99;33;89;56
35;35;2018-04-25 14:37:47.087;2018-04-25 16:14:36.750;97;34;89;55
35;35;2018-05-02 22:54:37.393;2018-05-02 23:25:58.147;31;33;50;17
32;32;2018-08-28 16:37:03.830;2018-08-28 17:47:17.020;70;34;89;55
32;32;2018-08-28 16:25:55.900;2018-08-28 17:47:17.020;82;34;89;55
35;35;2018-05-17 04:12:16.040;2018-05-17 05:29:02.070;77;34;89;55
35;35;2018-05-21 08:28:21.773;2018-05-21 09:46:50.457;78;33;89;56
32;32;2018-08-29 06:31:39.910;2018-08-29 07:42:46.160;71;34;89;55
32;32;2018-09-06 08:09:50.580;2018-09-06 09:29:40.697;80;33;89;56
35;35;2018-05-18 10:56:09.890;2018-05-18 12:12:28.733;76;34;89;55
35;35;2018-05-23 05:28:26.807;2018-05-23 06:47:41.320;79;34;89;55
35;35;2018-05-25 07:04:09.923;2018-05-25 08:24:22.607;80;34;89;55
35;35;2018-06-06 14:08:01.420;2018-06-06 15:31:59.637;83;33;89;56
34;34;2018-05-26 11:24:59.757;2018-05-26 11:43:33.530;19;33;35;2
35;35;2018-06-07 08:18:25.077;2018-06-07 11:05:22.967;167;34;89;55
35;35;2018-06-07 09:07:40.417;2018-06-07 11:05:22.967;118;34;89;55
35;35;2018-06-07 09:40:39.750;2018-06-07 11:05:22.967;85;34;89;55
34;34;2018-05-15 07:44:22.327;2018-05-15 09:07:11.430;83;31;89;58
32;32;2018-08-27 20:16:31.393;2018-08-28 02:30:23.543;374;33;89;56
32;32;2018-08-27 20:29:34.370;2018-08-28 02:30:23.543;361;33;89;56
32;32;2018-08-27 06:55:08.417;2018-08-27 08:19:08.953;84;34;89;55
35;35;2018-06-11 20:00:56.900;2018-06-11 21:20:46.690;80;34;89;55
32;32;2018-08-10 10:00:54.560;2018-08-10 11:24:46.577;84;33;89;56
35;35;2018-06-13 08:11:03.393;2018-06-13 09:30:57.437;79;34;89;55
35;35;2018-06-14 18:16:26.603;2018-06-14 19:40:02.697;84;34;89;55
34;34;2018-02-26 22:31:33.260;2018-02-26 23:54:43.057;83;34;89;55
34;34;2018-06-04 19:33:25.170;2018-06-04 20:51:05.227;78;33;89;56
32;32;2018-08-08 22:47:22.293;2018-08-09 00:10:35.767;83;34;89;55
34;34;2018-03-14 05:26:35.120;2018-03-14 18:36:32.730;790;33;89;56
34;34;2018-03-14 17:09:08.410;2018-03-14 18:36:32.730;87;31;89;58
34;34;2018-03-15 07:38:40.333;2018-03-15 09:03:32.130;85;34;89;55
35;35;2018-07-03 23:11:29.613;2018-07-04 00:31:16.920;80;31;89;58
35;35;2018-07-04 14:31:49.683;2018-07-04 15:48:35.280;77;33;89;56
32;32;2018-07-25 06:16:44.743;2018-07-25 07:31:56.280;75;34;89;55
32;32;2018-07-24 08:23:48.247;2018-07-24 12:47:01.893;264;29;89;60
34;34;2018-03-22 09:10:18.470;2018-03-22 10:25:16.790;75;43;89;46
35;35;2018-07-09 19:37:58.750;2018-07-09 21:07:07.960;90;34;89;55
35;35;2018-07-09 19:40:48.723;2018-07-09 21:07:07.960;87;34;89;55
34;34;2018-03-23 20:59:10.400;2018-03-23 22:43:04.050;104;32;89;57
34;34;2018-03-26 12:37:15.733;2018-03-26 14:17:34.773;100;34;89;55
34;34;2018-03-28 05:50:44.160;2018-03-28 07:45:27.160;115;33;89;56
34;34;2018-04-01 22:11:57.927;2018-04-02 00:31:02.960;140;30;89;59
35;35;2018-07-11 13:04:05.883;2018-07-11 14:39:29.370;95;34;89;55
35;35;2018-07-23 07:57:21.047;2018-07-23 09:23:04.100;86;34;89;55
35;35;2018-07-23 07:58:48.757;2018-07-23 09:23:04.100;85;34;89;55
34;34;2018-04-18 09:08:51.993;2018-04-18 10:11:07.030;63;34;78;44
34;34;2018-04-19 13:21:53.697;2018-04-19 14:39:11.317;78;33;89;56
35;35;2018-07-26 04:08:27.463;2018-07-26 05:26:53.780;78;33;89;56
34;34;2018-04-25 14:28:15.030;2018-04-25 22:04:05.337;456;33;89;56
34;34;2018-04-25 20:41:34.273;2018-04-25 22:04:05.337;83;34;89;55
35;35;2018-07-27 11:36:40.850;2018-07-27 12:55:05.100;79;33;89;56
35;35;2018-08-08 06:27:47.533;2018-08-08 07:48:57.273;81;33;89;56
35;35;2018-08-08 19:21:25.780;2018-08-08 20:42:03.923;81;34;89;55
34;34;2018-05-01 22:35:39.990;2018-05-02 00:04:19.447;89;31;89;58
35;35;2018-05-07 07:31:14.367;2018-05-07 09:16:46.440;105;33;89;56
34;34;2018-05-19 03:02:13.603;2018-05-19 04:33:22.167;91;33;89;56
32;32;2018-07-11 09:41:43.470;2018-07-11 10:58:17.250;77;33;89;56
32;32;2018-07-02 11:24:22.100;2018-07-02 15:43:15.923;259;33;34;1
32;32;2018-06-18 07:08:49.820;2018-06-18 08:28:00.120;80;31;89;58
35;35;2018-05-29 20:22:01.867;2018-05-29 21:45:04.030;83;34;89;55
32;32;2018-06-11 15:17:13.430;2018-06-11 16:32:55.833;75;34;89;55
32;32;2018-06-12 15:39:44.967;2018-06-12 17:00:59.187;81;34;89;55
32;32;2018-06-12 14:26:09.270;2018-06-12 17:00:59.187;154;34;89;55
34;34;2018-07-02 10:04:21.450;2018-07-02 11:22:15.940;78;33;83;50
34;34;2018-07-02 11:22:50.103;2018-07-02 11:50:35.120;28;83;89;6
35;35;2018-06-04 19:35:50.483;2018-06-04 21:07:24.307;92;33;89;56
35;35;2018-06-04 19:48:41.250;2018-06-04 21:07:24.307;79;33;89;56
34;34;2018-07-03 06:29:59.583;2018-07-03 08:12:27.677;103;34;89;55
32;32;2018-06-06 15:31:35.377;2018-06-06 16:50:37.873;79;34;89;55
32;32;2018-05-25 10:15:58.447;2018-05-25 11:52:39.230;97;34;89;55
32;32;2018-05-24 16:19:00.697;2018-05-24 17:59:43.663;100;34;89;55
35;35;2018-06-25 15:06:18.203;2018-06-26 01:09:09.083;603;33;89;56
34;34;2018-07-08 22:47:17.223;2018-07-09 17:07:20.137;1100;27;100;73
34;34;2018-07-04 13:20:29.773;2018-07-04 15:26:31.223;126;34;89;55
34;34;2018-07-05 10:25:59.140;2018-07-05 11:57:24.743;92;34;91;57
34;34;2018-07-10 13:23:22.530;2018-07-10 14:06:55.720;43;34;57;23
32;32;2018-09-25 21:23:34.393;2018-09-25 22:47:56.040;84;34;89;55
35;35;2018-07-16 14:50:37.813;2018-07-16 16:29:15.190;99;34;89;55
32;32;2018-09-24 08:19:34.340;2018-09-24 09:35:38.240;76;34;89;55
35;35;2018-07-19 04:06:59.060;2018-07-19 06:20:18.830;134;34;89;55
35;35;2018-07-19 04:27:34.323;2018-07-19 06:20:18.830;113;34;89;55
32;32;2018-09-18 12:00:00.237;2018-09-18 13:11:48.080;71;33;79;46
32;32;2018-09-19 07:04:51.670;2018-09-19 08:37:01.103;93;31;89;58
35;35;2018-08-02 01:36:31.597;2018-08-02 02:54:55.087;78;34;89;55
34;34;2018-07-23 09:38:12.360;2018-07-23 10:59:50.580;81;33;89;56
35;35;2018-08-03 11:57:14.560;2018-08-03 13:22:02.010;85;34;89;55
35;35;2018-08-04 07:57:48.840;2018-08-06 01:16:05.947;2479;39;89;50
35;35;2018-08-07 11:07:51.330;2018-08-07 12:31:40.270;84;33;89;56
32;32;2018-09-13 19:53:12.687;2018-09-13 21:22:15.917;89;33;89;56
35;35;2018-08-06 18:35:44.673;2018-08-06 19:55:20.507;80;33;89;56
32;32;2018-09-11 15:13:01.697;2018-09-11 16:36:46.770;83;33;89;56
35;35;2018-08-21 09:32:01.120;2018-08-21 11:00:25.330;88;33;89;56
35;35;2018-08-22 19:09:58.203;2018-08-22 20:40:39.947;91;34;89;55
34;34;2018-06-20 11:25:34.507;2018-06-20 13:06:41.097;101;34;89;55
35;35;2018-09-11 03:53:38.343;2018-09-11 05:27:59.690;94;33;89;56
35;35;2018-09-11 22:24:22.437;2018-09-12 08:58:53.260;634;33;89;56
35;35;2018-09-12 07:35:49.447;2018-09-12 08:58:53.260;83;33;89;56
32;32;2018-09-07 15:50:01.820;2018-09-07 18:01:26.913;131;34;66;32
32;32;2018-09-07 16:29:43.273;2018-09-07 18:01:26.913;92;34;66;32
32;32;2018-09-08 08:57:45.667;2018-09-08 10:24:35.437;87;32;89;57
35;35;2018-09-13 21:03:26.903;2018-09-13 22:29:08.497;86;33;89;56
34;34;2018-06-22 14:49:41.480;2018-06-22 16:33:52.603;104;34;89;55
35;35;2018-09-17 11:18:15.187;2018-09-17 11:50:02.130;32;60;82;22
32;32;2018-08-24 09:20:52.390;2018-08-24 09:25:43.983;5;84;87;3
35;35;2018-06-26 14:55:23.423;2018-06-26 16:17:45.300;82;34;89;55
35;35;2018-07-12 13:36:44.113;2018-07-12 15:06:37.423;90;34;89;55
35;35;2018-07-13 15:01:56.790;2018-07-13 16:40:14.857;99;33;89;56
35;35;2018-07-17 09:23:27.957;2018-07-17 11:03:39.777;100;34;89;55
35;35;2018-07-18 06:37:30.157;2018-07-18 08:19:46.353;102;33;89;56
35;35;2018-07-20 16:29:34.530;2018-07-20 17:46:12.473;77;33;89;56
34;34;2018-07-06 10:52:03.100;2018-07-06 12:08:31.440;76;34;89;55
32;32;2018-09-19 21:24:49.617;2018-09-19 22:55:52.910;91;33;89;56
32;32;2018-09-18 11:54:53.950;2018-09-18 13:11:48.080;77;33;79;46
35;35;2018-07-31 15:53:20.750;2018-07-31 17:09:57.580;76;34;89;55
34;34;2018-07-23 23:38:23.513;2018-07-24 00:59:39.033;81;33;89;56
34;34;2018-07-21 01:21:09.817;2018-07-23 10:59:50.580;3458;32;89;57
34;34;2018-07-24 14:28:59.180;2018-07-24 15:50:31.493;82;34;89;55
35;35;2018-08-06 13:31:36.637;2018-08-06 19:55:20.507;384;34;89;55
35;35;2018-08-06 18:31:13.807;2018-08-06 19:55:20.507;84;33;89;56
35;35;2018-08-16 11:31:23.790;2018-08-16 12:44:45.297;73;37;89;52
34;34;2018-07-25 07:42:22.190;2018-07-25 09:04:22.233;82;33;89;56
32;32;2018-08-23 12:17:52.743;2018-08-23 13:47:24.960;90;34;89;55
32;32;2018-09-10 15:16:10.193;2018-09-10 16:45:53.123;89;34;89;55
34;34;2018-08-27 16:58:07.187;2018-08-27 19:31:56.003;153;34;89;55
35;35;2018-09-06 17:23:09.340;2018-09-07 14:38:39.810;1275;87;89;2
35;35;2018-09-07 12:42:58.640;2018-09-07 14:38:39.810;116;34;89;55
35;35;2018-09-07 12:49:51.350;2018-09-07 14:38:39.810;109;34;89;55
34;34;2018-06-05 12:11:55.017;2018-06-05 13:30:56.247;79;34;89;55
34;34;2018-06-20 11:23:15.397;2018-06-20 13:06:41.097;103;34;89;55
34;34;2018-06-20 11:26:12.863;2018-06-20 13:06:41.097;100;34;89;55
34;34;2018-06-20 11:46:27.323;2018-06-20 13:06:41.097;80;34;89;55
32;32;2018-09-07 15:34:28.457;2018-09-07 15:40:07.833;6;33;34;1
35;35;2018-09-13 05:11:48.883;2018-09-13 06:40:59.330;89;33;89;56
34;34;2018-06-21 18:11:50.540;2018-06-21 19:37:02.350;86;33;89;56
35;35;2018-09-17 10:22:41.270;2018-09-17 10:59:56.473;37;33;62;29
35;35;2018-09-18 12:00:54.780;2018-09-18 14:00:07.163;120;33;89;56
35;35;2018-09-18 12:13:54.897;2018-09-18 14:00:07.163;107;33;89;56
32;32;2018-08-21 14:12:08.170;2018-08-21 15:58:36.057;106;33;89;56
32;32;2018-08-22 08:54:49.433;2018-08-22 09:37:42.340;43;34;40;6
32;32;2018-08-22 08:57:30.383;2018-08-22 09:37:42.340;40;34;40;6
34;34;2018-06-25 10:30:51.183;2018-06-25 11:56:12.897;86;34;89;55
35;35;2018-09-24 14:55:19.433;2018-09-25 17:54:45.320;1619;34;100;66
35;35;2018-09-24 15:20:00.647;2018-09-25 17:54:45.320;1594;34;100;66
32;32;2018-08-18 14:01:46.707;2018-08-18 16:04:01.937;123;56;100;44
34;34;2018-07-13 15:06:25.233;2018-07-13 16:42:00.503;96;31;89;58
32;32;2018-08-04 06:31:54.870;2018-08-04 07:53:44.923;82;34;89;55
35;35;2018-08-09 19:12:27.320;2018-08-09 20:32:49.783;80;33;89;56
35;35;2018-08-13 19:22:50.120;2018-08-14 14:22:46.693;1140;33;34;1
35;35;2018-08-14 14:34:59.717;2018-08-14 20:33:21.230;359;34;100;66
35;35;2018-08-14 14:45:09.693;2018-08-14 20:33:21.230;348;34;100;66
35;35;2018-08-14 14:46:04.800;2018-08-14 20:33:21.230;347;34;100;66
35;35;2018-08-14 14:47:10.843;2018-08-14 20:33:21.230;346;34;100;66
32;32;2018-07-31 09:02:51.507;2018-07-31 09:28:57.587;26;33;53;20
35;35;2018-08-27 14:31:26.330;2018-08-27 15:46:48.043;75;33;89;56
35;35;2018-08-28 07:34:23.783;2018-08-28 08:49:35.120;75;33;89;56
35;35;2018-08-28 18:48:40.170;2018-08-28 20:16:05.550;88;34;89;55
35;35;2018-08-29 12:16:23.260;2018-08-29 12:23:00.673;7;33;37;4
35;35;2018-08-29 10:41:25.940;2018-08-29 12:23:00.673;102;33;37;4
35;35;2018-08-29 12:24:29.293;2018-08-29 13:32:28.527;68;37;89;52
32;32;2018-07-18 17:17:02.107;2018-07-18 18:44:49.017;87;30;89;59
35;35;2018-08-29 15:08:58.183;2018-08-29 15:11:51.420;3;87;89;2
32;32;2018-07-13 04:39:23.910;2018-07-13 10:12:44.707;333;33;89;56
32;32;2018-07-13 04:51:41.723;2018-07-13 10:12:44.707;321;33;89;56
32;32;2018-07-13 08:52:36.213;2018-07-13 10:12:44.707;80;33;89;56
34;34;2018-07-20 05:22:29.560;2018-07-20 06:06:35.973;44;33;63;30
35;35;2018-08-31 11:49:06.560;2018-08-31 12:17:47.310;28;33;49;16
32;32;2018-07-12 09:37:02.907;2018-07-12 11:42:43.620;125;32;89;57
32;32;2018-06-28 02:50:33.013;2018-06-28 04:00:38.423;70;34;89;55
34;34;2018-07-30 21:41:50.073;2018-07-30 23:25:59.793;104;34;89;55
34;34;2018-07-30 21:44:51.690;2018-07-30 23:25:59.793;101;34;89;55
32;32;2018-06-26 13:42:55.447;2018-06-26 16:07:08.067;145;33;89;56
35;35;2018-09-05 10:11:50.860;2018-09-05 23:01:59.643;770;34;89;55
32;32;2018-06-27 07:53:03.720;2018-06-27 09:39:28.317;106;34;99;65
32;32;2018-06-22 17:08:15.217;2018-06-22 18:29:20.883;81;33;89;56
32;32;2018-06-21 07:45:26.883;2018-06-21 08:05:12.773;20;34;46;12
32;32;2018-06-05 23:55:36.280;2018-06-06 01:12:11.107;77;33;89;56
34;34;2018-08-03 05:59:08.150;2018-08-03 06:29:48.330;30;33;54;21
34;34;2018-09-06 13:21:06.760;2018-09-06 15:02:06.750;101;34;89;55
34;34;2018-09-09 23:31:37.497;2018-09-10 05:11:53.670;340;19;89;70
34;34;2018-09-09 23:53:25.237;2018-09-10 05:11:53.670;318;18;89;71
34;34;2018-09-07 06:27:55.323;2018-09-07 07:43:36.643;76;33;89;56
32;32;2018-05-11 12:50:35.033;2018-05-11 14:03:37.923;73;33;77;44
34;34;2018-09-13 08:28:09.450;2018-09-13 10:41:38.800;133;28;89;61
34;34;2018-09-12 23:41:11.770;2018-09-13 10:41:38.800;660;34;89;55
32;32;2018-05-09 12:55:18.157;2018-05-09 14:08:52.713;73;33;89;56
32;32;2018-04-09 05:01:04.653;2018-04-09 10:29:26.700;328;11;100;89
32;32;2018-04-10 04:56:43.140;2018-04-10 06:16:36.890;80;33;89;56
37;37;2018-09-03 10:44:54.587;2018-09-03 12:05:28.213;81;33;89;56
32;32;2018-05-04 20:06:55.847;2018-05-04 20:51:59.130;45;34;50;16
32;32;2018-05-04 20:18:47.997;2018-05-04 20:51:59.130;33;34;50;16
34;34;2018-09-14 05:42:20.347;2018-09-14 06:33:16.943;51;28;63;35
34;34;2018-09-17 12:30:22.077;2018-09-17 13:03:43.190;33;34;55;21
37;37;2018-08-30 23:04:14.893;2018-08-31 00:21:08.543;77;34;89;55
34;34;2018-09-20 03:45:09.130;2018-09-20 05:13:17.547;88;33;89;56
32;32;2018-05-18 08:02:44.723;2018-05-18 09:33:02.313;91;31;89;58
32;32;2018-05-16 12:50:32.180;2018-05-16 14:13:38.127;83;34;89;55
34;34;2018-09-24 20:37:55.080;2018-09-25 20:49:17.810;1452;33;84;51
34;34;2018-09-24 21:16:39.417;2018-09-25 20:49:17.810;1413;31;84;53
34;34;2018-09-25 06:07:11.347;2018-09-25 20:49:17.810;882;28;84;56
34;34;2018-09-25 19:15:08.107;2018-09-25 20:49:17.810;94;33;84;51
32;32;2018-04-29 23:35:45.813;2018-04-30 04:52:45.167;317;36;100;64
37;37;2018-08-28 07:55:56.147;2018-08-28 10:49:53.400;174;33;62;29
37;37;2018-08-28 08:43:59.740;2018-08-28 10:49:53.400;126;39;62;23
32;32;2018-04-25 10:19:56.623;2018-04-25 11:41:05.250;82;33;89;56
32;32;2018-04-26 03:07:26.043;2018-04-26 04:28:27.303;81;34;89;55
32;32;2018-04-24 05:51:36.700;2018-04-24 07:07:39.377;76;34;89;55
32;32;2018-04-19 05:30:41.037;2018-04-19 06:46:15.283;76;33;89;56
34;34;2018-09-28 01:57:19.803;2018-09-28 03:32:04.880;95;33;89;56
37;37;2018-08-16 05:59:07.483;2018-08-16 06:45:01.700;46;18;40;22
34;34;2018-08-28 14:25:56.793;2018-08-28 22:02:24.627;457;34;89;55
34;34;2018-08-29 17:34:33.560;2018-08-30 00:46:06.570;432;34;65;31
34;34;2018-08-29 17:46:19.517;2018-08-30 00:46:06.570;420;34;65;31
34;34;2018-08-29 17:48:44.930;2018-08-30 00:46:06.570;418;34;65;31
32;32;2018-03-27 04:20:19.440;2018-03-27 06:09:29.147;109;34;89;55
32;32;2018-03-27 21:44:20.787;2018-03-27 23:42:24.433;118;34;89;55
32;32;2018-03-20 10:42:47.800;2018-03-20 12:08:18.190;86;34;89;55
34;34;2018-09-03 16:16:15.557;2018-09-03 17:35:51.180;79;32;89;57
34;34;2018-09-04 08:47:15.633;2018-09-04 10:17:40.270;90;34;89;55
32;32;2018-02-23 07:06:41.953;2018-02-23 08:25:34.447;79;32;89;57
32;32;2018-02-21 03:06:24.243;2018-02-21 05:32:38.407;146;33;89;56
37;37;2018-08-12 00:00:03.580;2018-08-12 05:21:52.377;321;75;100;25
32;32;2018-03-13 05:28:14.207;2018-03-13 06:50:19.970;82;34;84;50
34;34;2018-09-05 19:35:51.173;2018-09-05 22:05:53.807;150;33;89;56
36;36;2018-08-30 16:20:06.123;2018-08-30 17:48:23.127;88;33;89;56
32;32;2018-04-04 12:02:32.177;2018-04-04 14:26:34.173;144;34;93;59
36;36;2018-09-03 08:07:21.037;2018-09-03 09:56:22.983;109;34;89;55
37;37;2018-09-28 07:36:06.153;2018-09-28 08:50:28.637;74;34;89;55
36;36;2018-08-28 08:21:20.377;2018-08-28 09:58:59.370;97;33;89;56
36;36;2018-08-28 08:25:32.837;2018-08-28 09:58:59.370;93;33;89;56
36;36;2018-09-11 09:02:34.900;2018-09-12 07:28:38.813;1346;17;86;69
36;36;2018-09-07 09:32:30.077;2018-09-12 07:28:38.813;7076;55;86;31
35;35;2018-08-18 01:13:07.307;2018-08-18 02:55:08.103;102;32;89;57
34;34;2018-07-27 08:49:04.477;2018-07-27 10:39:25.470;110;34;89;55
35;35;2018-08-23 13:43:24.237;2018-08-23 15:19:00.290;96;33;89;56
34;34;2018-08-27 16:30:23.033;2018-08-27 19:31:56.003;181;34;89;55
34;34;2018-08-27 16:31:52.673;2018-08-27 19:31:56.003;180;34;89;55
34;34;2018-08-27 16:38:32.520;2018-08-27 19:31:56.003;173;34;89;55
35;35;2018-09-06 15:01:08.570;2018-09-06 15:21:10.530;20;33;39;6
35;35;2018-09-07 12:36:34.720;2018-09-07 14:38:39.810;122;34;89;55
35;35;2018-09-07 12:43:51.730;2018-09-07 14:38:39.810;115;34;89;55
35;35;2018-09-07 08:52:28.240;2018-09-07 14:38:39.810;346;33;89;56
34;34;2018-06-20 11:47:33.097;2018-06-20 13:06:41.097;79;34;89;55
34;34;2018-06-21 13:09:49.530;2018-06-21 13:39:04.343;30;33;48;15
35;35;2018-09-10 20:19:30.657;2018-09-11 05:27:59.690;548;33;89;56
35;35;2018-09-13 05:16:41.233;2018-09-13 06:40:59.330;84;33;89;56
32;32;2018-08-24 07:08:06.387;2018-08-24 09:20:47.687;132;33;84;51
32;32;2018-08-24 07:41:30.677;2018-08-24 09:20:47.687;99;33;84;51
32;32;2018-08-22 12:39:28.840;2018-08-22 21:11:37.360;512;34;89;55
32;32;2018-08-22 19:43:36.803;2018-08-22 21:11:37.360;88;32;89;57
35;35;2018-09-18 12:09:44.330;2018-09-18 14:00:07.163;111;33;89;56
32;32;2018-08-21 14:28:55.800;2018-08-21 15:58:36.057;90;33;89;56
32;32;2018-08-22 08:51:50.193;2018-08-22 09:37:42.340;46;34;40;6
32;32;2018-08-22 08:55:53.983;2018-08-22 09:37:42.340;42;34;40;6
35;35;2018-09-19 05:29:40.837;2018-09-19 06:50:36.323;81;32;89;57
35;35;2018-09-20 03:40:41.890;2018-09-20 06:26:31.960;166;33;89;56
35;35;2018-09-20 03:44:05.207;2018-09-20 06:26:31.960;162;33;89;56
35;35;2018-09-21 11:42:11.380;2018-09-21 12:53:08.627;71;44;89;45
34;34;2018-06-26 03:10:08.297;2018-06-26 05:01:15.593;111;33;89;56
34;34;2018-06-26 03:29:32.783;2018-06-26 05:01:15.593;92;33;89;56
35;35;2018-09-23 23:11:46.503;2018-09-24 00:46:50.717;95;29;82;53
35;35;2018-09-23 23:20:22.453;2018-09-24 00:46:50.717;86;29;82;53
35;35;2018-09-23 23:26:33.630;2018-09-24 00:46:50.717;80;29;82;53
35;35;2018-09-26 09:28:32.370;2018-09-26 10:49:26.423;81;33;89;56
34;34;2018-06-27 19:49:15.473;2018-06-28 10:54:13.363;905;33;89;56
34;34;2018-06-27 19:52:28.430;2018-06-28 10:54:13.363;902;33;89;56
34;34;2018-07-13 03:54:07.720;2018-07-13 11:42:17.560;468;33;34;1
32;32;2018-08-20 09:21:40.283;2018-08-20 10:53:43.690;92;34;89;55
32;32;2018-08-20 09:33:53.130;2018-08-20 10:53:43.690;80;34;89;55
35;35;2018-09-27 04:40:51.980;2018-09-27 06:07:26.097;87;33;89;56
32;32;2018-08-16 15:17:35.060;2018-08-16 21:26:58.413;369;33;100;67
32;32;2018-08-14 22:11:04.990;2018-08-16 21:26:58.413;2835;37;100;63
34;34;2018-07-16 11:44:13.213;2018-07-16 13:15:36.870;91;34;88;54
34;34;2018-07-13 11:44:27.270;2018-07-13 16:42:00.503;298;34;89;55
32;32;2018-08-02 13:01:24.980;2018-08-02 14:33:04.177;92;34;89;55
34;34;2018-07-18 12:41:08.020;2018-07-18 12:58:03.640;17;52;64;12
35;35;2018-08-14 14:33:34.683;2018-08-14 20:33:21.230;360;34;100;66
32;32;2018-07-20 04:26:37.160;2018-07-20 05:11:20.033;45;33;64;31
35;35;2018-08-29 12:16:07.840;2018-08-29 12:23:00.673;7;33;37;4
32;32;2018-07-13 08:49:57.920;2018-07-13 10:12:44.707;83;33;89;56
32;32;2018-07-16 07:05:22.430;2018-07-16 08:33:16.727;88;29;89;60
34;34;2018-07-19 13:28:06.003;2018-07-19 14:44:46.620;76;33;89;56
35;35;2018-09-05 13:02:52.673;2018-09-05 23:01:59.643;599;34;89;55
35;35;2018-09-05 21:37:43.733;2018-09-05 23:01:59.643;84;33;89;56
32;32;2018-06-21 22:47:06.523;2018-06-22 00:05:47.503;78;34;89;55
32;32;2018-06-19 13:10:00.727;2018-06-19 14:27:12.650;77;34;89;55
32;32;2018-06-21 06:18:52.027;2018-06-21 08:05:12.773;107;37;46;9
32;32;2018-06-05 12:06:51.540;2018-06-06 01:12:11.107;786;83;89;6
32;32;2018-06-04 13:11:32.027;2018-06-05 06:41:49.297;1050;34;89;55
32;32;2018-06-04 13:04:16.997;2018-06-05 06:41:49.297;1057;34;89;55
34;34;2018-08-04 04:13:10.703;2018-08-04 05:32:53.620;79;32;89;57
32;32;2018-05-30 01:49:18.617;2018-05-30 03:01:12.870;72;33;89;56
34;34;2018-09-06 13:06:12.193;2018-09-06 15:02:06.750;116;34;89;55
34;34;2018-09-09 23:26:53.630;2018-09-10 05:11:53.670;345;20;89;69
34;34;2018-09-10 03:18:17.857;2018-09-10 05:11:53.670;113;16;89;73
34;34;2018-09-08 01:40:13.920;2018-09-10 05:11:53.670;3091;33;89;56
32;32;2018-05-14 21:26:33.673;2018-05-14 22:46:38.967;80;34;89;55
32;32;2018-05-11 09:11:43.000;2018-05-11 12:49:41.370;218;32;33;1
32;32;2018-05-11 12:49:47.850;2018-05-11 14:03:37.923;74;33;77;44
32;32;2018-05-10 15:47:01.710;2018-05-10 17:32:32.993;105;34;89;55
37;37;2018-09-05 11:50:30.653;2018-09-05 13:12:42.013;82;33;89;56
34;34;2018-09-12 22:34:22.210;2018-09-13 10:41:38.800;727;34;89;55
34;34;2018-09-12 23:26:41.213;2018-09-13 10:41:38.800;675;34;89;55
37;37;2018-09-06 10:29:21.853;2018-09-06 11:49:53.227;80;34;89;55
32;32;2018-04-16 21:07:08.703;2018-04-16 22:46:49.133;99;34;89;55
32;32;2018-05-03 13:33:47.880;2018-05-03 15:10:32.387;97;33;89;56
32;32;2018-05-04 04:53:35.843;2018-05-04 06:21:01.953;88;33;89;56
32;32;2018-05-07 18:51:35.947;2018-05-07 20:30:37.150;99;34;89;55
37;37;2018-09-03 23:42:26.770;2018-09-04 01:03:11.227;81;33;89;56
32;32;2018-04-06 08:42:03.627;2018-04-06 10:01:01.547;79;33;89;56
32;32;2018-05-21 15:56:03.080;2018-05-21 17:24:49.437;88;34;89;55
37;37;2018-08-30 09:27:59.630;2018-08-30 11:09:54.763;102;34;89;55
32;32;2018-05-02 16:07:26.443;2018-05-02 17:29:14.637;82;34;89;55
34;34;2018-09-24 01:03:16.193;2018-09-24 02:28:38.283;85;33;89;56
34;34;2018-09-24 20:32:29.383;2018-09-25 20:49:17.810;1457;33;84;51
34;34;2018-09-24 20:43:29.013;2018-09-25 20:49:17.810;1446;33;84;51
34;34;2018-09-24 21:16:31.930;2018-09-25 20:49:17.810;1413;31;84;53
37;37;2018-08-27 22:00:50.813;2018-08-28 10:49:53.400;769;33;62;29
37;37;2018-08-28 08:19:55.950;2018-08-28 10:49:53.400;150;33;62;29
37;37;2018-08-28 08:26:25.753;2018-08-28 10:49:53.400;143;33;62;29
37;37;2018-08-28 10:17:08.790;2018-08-28 10:49:53.400;32;39;62;23
37;37;2018-08-10 10:11:23.937;2018-08-10 11:45:10.207;94;33;89;56
34;34;2018-09-28 17:50:17.670;2018-09-28 19:14:33.600;84;33;92;59
32;32;2018-04-24 17:30:08.957;2018-04-24 18:48:31.027;78;33;89;56
32;32;2018-04-20 08:56:50.160;2018-04-20 10:12:25.110;76;33;89;56
32;32;2018-04-19 17:33:36.243;2018-04-19 18:46:50.767;73;34;89;55
32;32;2018-04-17 14:21:32.413;2018-04-17 16:09:30.763;108;34;89;55
34;34;2018-08-29 17:31:57.780;2018-08-30 00:46:06.570;435;34;65;31
32;32;2018-03-22 20:01:41.910;2018-03-22 21:38:15.473;97;34;89;55
37;37;2018-08-27 07:10:34.973;2018-08-27 08:37:36.840;87;34;89;55
32;32;2018-03-21 06:01:34.493;2018-03-21 07:34:10.620;93;34;89;55
34;34;2018-09-03 09:22:14.240;2018-09-03 17:35:51.180;493;34;89;55
34;34;2018-09-03 12:05:04.550;2018-09-03 17:35:51.180;330;34;89;55
34;34;2018-09-03 12:06:27.243;2018-09-03 17:35:51.180;329;34;89;55
34;34;2018-09-03 12:07:05.480;2018-09-03 17:35:51.180;328;34;89;55
32;32;2018-02-23 07:08:27.630;2018-02-23 08:25:34.447;77;32;89;57
37;37;2018-08-11 12:59:53.040;2018-08-11 14:19:36.320;80;31;89;58
32;32;2018-02-25 23:47:11.803;2018-02-26 01:07:46.290;80;30;89;59
32;32;2017-12-16 06:01:10.900;2017-12-16 11:17:54.837;316;33;100;67
34;34;2018-09-05 20:49:29.757;2018-09-05 22:05:53.807;76;33;89;56
32;32;2018-03-13 06:50:55.197;2018-03-13 07:14:10.673;24;84;89;5
36;36;2018-09-03 08:20:07.850;2018-09-03 09:56:22.983;96;34;89;55
36;36;2018-08-29 22:29:57.917;2018-08-29 23:57:08.900;88;30;89;59
32;32;2018-03-07 09:40:44.217;2018-03-07 10:55:04.373;75;44;89;45
36;36;2018-08-28 23:40:44.163;2018-08-29 01:12:47.477;92;33;89;56
36;36;2018-08-28 23:50:02.997;2018-08-29 01:12:47.477;82;33;89;56
32;32;2018-03-02 06:28:07.473;2018-03-02 07:52:32.953;84;33;89;56
36;36;2018-08-28 08:20:23.693;2018-08-28 09:58:59.370;98;33;89;56
36;36;2018-09-07 15:55:56.563;2018-09-12 07:28:38.813;6693;33;86;53
36;36;2018-09-08 06:08:38.503;2018-09-12 07:28:38.813;5840;33;86;53
32;32;2017-12-27 08:31:32.260;2017-12-27 10:47:45.717;136;34;89;55
32;32;2017-12-28 03:30:43.343;2017-12-28 05:55:51.030;145;34;89;55
32;32;2017-12-30 06:01:48.790;2018-01-02 11:31:23.180;4650;50;79;29
32;32;2017-12-30 09:58:25.590;2018-01-02 11:31:23.180;4413;47;79;32
36;36;2018-09-24 22:54:15.603;2018-09-25 00:22:06.137;88;33;89;56
32;32;2018-01-08 09:16:27.353;2018-01-08 09:45:01.093;29;33;44;11
32;32;2018-01-08 13:32:09.070;2018-01-08 15:28:39.243;116;33;89;56
32;32;2018-01-09 07:57:03.493;2018-01-09 10:01:27.870;124;34;89;55
32;32;2018-01-09 07:58:09.580;2018-01-09 10:01:27.870;123;34;89;55
35;35;2018-09-18 12:05:58.850;2018-09-18 14:00:07.163;115;33;89;56
35;35;2018-09-18 12:23:35.547;2018-09-18 14:00:07.163;97;33;89;56
32;32;2018-08-21 14:28:03.223;2018-08-21 15:58:36.057;90;33;89;56
35;35;2018-09-19 20:47:32.430;2018-09-20 06:26:31.960;579;33;89;56
34;34;2018-06-25 10:25:10.213;2018-06-25 11:56:12.897;91;34;89;55
34;34;2018-06-25 10:27:42.000;2018-06-25 11:56:12.897;89;34;89;55
34;34;2018-06-26 03:27:43.117;2018-06-26 05:01:15.593;94;33;89;56
34;34;2018-06-28 09:12:20.010;2018-06-28 10:54:13.363;102;34;89;55
35;35;2018-09-23 22:37:11.233;2018-09-24 00:46:50.717;129;13;82;69
35;35;2018-09-23 23:19:15.060;2018-09-24 00:46:50.717;87;29;82;53
35;35;2018-09-24 15:42:07.863;2018-09-25 17:54:45.320;1572;34;100;66
35;35;2018-09-27 20:25:42.270;2018-09-27 21:48:00.983;83;34;89;55
34;34;2018-07-17 06:20:28.853;2018-07-17 07:35:25.767;75;34;89;55
32;32;2018-08-02 13:03:15.423;2018-08-02 14:33:04.177;90;34;89;55
35;35;2018-08-10 12:13:14.440;2018-08-10 13:33:49.033;80;34;89;55
35;35;2018-08-12 22:27:31.640;2018-08-13 01:28:17.450;181;2;96;94
35;35;2018-08-12 22:43:49.773;2018-08-13 01:28:17.450;165;1;96;95
34;34;2018-07-18 12:19:26.810;2018-07-18 12:58:03.640;39;35;64;29
34;34;2018-07-18 12:47:55.150;2018-07-18 12:58:03.640;11;56;64;8
32;32;2018-07-20 11:10:38.983;2018-07-20 12:34:05.190;84;34;89;55
35;35;2018-08-29 10:51:18.107;2018-08-29 12:23:00.673;92;33;37;4
32;32;2018-07-19 11:13:30.353;2018-07-19 12:41:11.397;88;34;89;55
34;34;2018-07-17 18:46:00.497;2018-07-17 20:02:32.790;76;33;89;56
35;35;2018-08-30 06:56:26.280;2018-08-30 08:13:49.110;77;34;89;55
32;32;2018-07-17 02:06:14.613;2018-07-17 04:13:08.480;127;32;89;57
32;32;2018-07-17 02:45:14.273;2018-07-17 04:13:08.480;88;31;89;58
32;32;2018-06-28 15:55:21.217;2018-06-28 17:07:24.593;72;33;89;56
35;35;2018-08-31 12:17:51.387;2018-09-03 04:17:17.063;3840;49;100;51
35;35;2018-09-02 22:25:09.107;2018-09-03 04:17:17.063;352;30;100;70
32;32;2018-05-31 10:14:45.433;2018-05-31 11:28:03.800;74;34;89;55
32;32;2018-05-31 10:18:18.047;2018-05-31 11:28:03.800;70;34;89;55
32;32;2018-06-26 14:01:24.647;2018-06-26 16:07:08.067;126;33;89;56
32;32;2018-06-25 14:40:48.527;2018-06-25 16:04:05.410;84;34;89;55
32;32;2018-06-21 05:59:03.140;2018-06-21 08:05:12.773;126;33;46;13
32;32;2018-06-21 08:05:19.300;2018-06-21 09:11:08.880;66;46;89;43
32;32;2018-06-21 08:08:42.820;2018-06-21 09:11:08.880;63;46;89;43
32;32;2018-06-20 07:00:59.623;2018-06-20 08:18:46.120;78;33;89;56
32;32;2018-06-18 23:04:04.453;2018-06-19 00:18:14.667;74;34;89;55
32;32;2018-06-05 04:07:16.067;2018-06-05 06:41:49.297;154;19;89;70
32;32;2018-06-01 01:03:59.593;2018-06-01 02:22:10.383;79;33;89;56
34;34;2018-09-06 13:29:49.173;2018-09-06 15:02:06.750;93;34;89;55
32;32;2018-05-30 14:23:50.040;2018-05-30 15:38:07.933;75;33;89;56
32;32;2018-05-29 10:14:34.930;2018-05-29 12:38:50.247;144;34;92;58
34;34;2018-09-09 23:24:25.683;2018-09-10 05:11:53.670;347;22;89;67
32;32;2018-04-13 00:50:18.037;2018-04-13 02:21:43.750;91;33;89;56
34;34;2018-09-12 07:30:17.257;2018-09-12 08:49:32.090;79;33;89;56
32;32;2018-05-08 17:12:05.180;2018-05-08 19:07:09.667;115;34;89;55
32;32;2018-04-12 06:22:34.387;2018-04-12 07:46:44.490;84;34;89;55
32;32;2018-04-10 19:21:46.100;2018-04-10 20:40:18.440;79;34;89;55
34;34;2018-09-13 08:29:07.500;2018-09-13 10:41:38.800;132;28;89;61
34;34;2018-09-12 23:40:03.060;2018-09-13 10:41:38.800;661;34;89;55
32;32;2018-04-11 11:18:43.870;2018-04-11 12:31:31.743;73;34;84;50
32;32;2018-04-13 15:45:46.227;2018-04-13 17:23:02.300;98;34;89;55
32;32;2018-04-16 07:56:20.137;2018-04-16 09:36:14.303;100;34;89;55
32;32;2018-05-04 20:26:40.700;2018-05-04 20:51:59.130;25;34;50;16
32;32;2018-05-06 23:12:07.437;2018-05-07 00:42:10.413;90;38;89;51
37;37;2018-08-31 14:44:48.663;2018-08-31 16:05:52.870;81;31;89;58
34;34;2018-09-15 09:51:55.607;2018-09-17 13:03:43.190;3072;51;55;4
34;34;2018-09-19 08:14:37.643;2018-09-19 09:37:38.157;83;34;89;55
32;32;2018-05-19 04:51:40.953;2018-05-19 06:20:36.697;89;33;89;56
37;37;2018-08-29 10:16:35.047;2018-08-29 11:50:57.440;94;33;89;56
32;32;2018-05-16 12:53:32.090;2018-05-16 14:13:38.127;80;34;89;55
32;32;2018-04-30 19:16:40.107;2018-04-30 20:34:40.280;78;34;89;55
32;32;2018-05-02 03:37:59.670;2018-05-02 04:55:59.690;78;34;89;55
32;32;2018-05-15 16:38:23.640;2018-05-15 18:00:02.430;82;34;89;55
32;32;2018-04-27 09:25:34.050;2018-04-27 10:50:44.263;85;33;89;56
34;34;2018-09-24 20:27:38.560;2018-09-25 20:49:17.810;1462;33;84;51
34;34;2018-09-25 19:11:11.840;2018-09-25 20:49:17.810;98;33;84;51
34;34;2018-09-26 11:06:56.943;2018-09-26 12:38:54.210;92;34;89;55
37;37;2018-08-28 07:35:04.777;2018-08-28 10:49:53.400;194;31;62;31
37;37;2018-08-28 08:20:40.643;2018-08-28 10:49:53.400;149;33;62;29
37;37;2018-08-28 08:27:18.080;2018-08-28 10:49:53.400;142;33;62;29
32;32;2018-04-26 15:23:40.767;2018-04-26 16:45:09.007;82;33;89;56
32;32;2018-04-25 10:22:38.213;2018-04-25 11:41:05.250;79;33;89;56
37;37;2018-08-28 16:46:26.140;2018-08-28 18:18:24.503;92;34;89;55
32;32;2018-04-18 09:42:56.217;2018-04-18 11:37:58.600;115;34;89;55
32;32;2018-03-26 07:11:54.690;2018-03-26 09:00:23.873;109;34;89;55
34;34;2018-08-28 17:48:19.600;2018-08-28 22:02:24.627;254;33;89;56
34;34;2018-08-29 23:43:16.463;2018-08-30 00:46:06.570;63;33;65;32
34;34;2018-08-30 00:46:14.450;2018-08-30 01:21:40.137;35;65;89;24
34;34;2018-08-31 10:56:36.850;2018-08-31 11:19:25.193;23;34;51;17
32;32;2018-03-14 09:04:35.090;2018-03-14 10:57:59.697;113;34;89;55
32;32;2018-03-16 10:02:09.803;2018-03-16 12:14:52.707;132;30;89;59
32;32;2018-03-19 07:36:12.470;2018-03-19 13:08:02.720;332;26;100;74
34;34;2018-09-03 09:08:07.030;2018-09-03 17:35:51.180;507;34;89;55
34;34;2018-09-04 09:45:21.997;2018-09-04 10:17:40.270;32;66;89;23
32;32;2018-02-21 03:48:48.200;2018-02-21 05:32:38.407;104;33;89;56
32;32;2018-02-26 13:28:41.470;2018-02-26 14:45:14.593;77;33;89;56
32;32;2018-02-27 08:06:24.590;2018-02-27 09:21:33.810;75;34;89;55
32;32;2017-12-18 13:04:51.090;2017-12-18 14:51:11.833;107;34;89;55
34;34;2018-09-05 20:32:10.757;2018-09-05 22:05:53.807;93;33;89;56
36;36;2018-09-04 19:51:58.260;2018-09-04 21:53:46.757;122;34;92;58
32;32;2018-04-02 11:35:13.420;2018-04-02 15:27:36.680;232;34;89;55
32;32;2018-04-03 09:16:35.517;2018-04-03 13:20:23.917;244;34;89;55
32;32;2018-03-06 10:34:01.047;2018-03-06 11:52:50.777;78;33;84;51
37;37;2018-09-27 16:57:54.820;2018-09-27 18:11:56.680;74;35;89;54
36;36;2018-08-29 21:19:28.780;2018-08-29 23:57:08.900;158;30;89;59
36;36;2018-08-29 22:29:11.160;2018-08-29 23:57:08.900;88;30;89;59
36;36;2018-08-28 21:59:24.547;2018-08-29 01:12:47.477;193;33;89;56
36;36;2018-08-28 22:14:45.570;2018-08-29 01:12:47.477;178;33;89;56
32;32;2018-03-08 07:05:22.420;2018-03-08 08:40:39.557;95;33;89;56
36;36;2018-09-12 04:51:44.723;2018-09-12 07:28:38.813;157;33;86;53
36;36;2018-09-12 05:53:11.383;2018-09-12 07:28:38.813;95;33;86;53
36;36;2018-09-07 08:30:10.520;2018-09-12 07:28:38.813;7138;33;86;53
37;37;2018-09-26 04:18:47.017;2018-09-26 05:33:10.597;75;33;89;56
32;32;2018-03-09 01:43:33.573;2018-03-09 03:26:30.147;103;32;89;57
32;32;2018-03-12 05:02:13.757;2018-03-12 06:43:21.463;101;33;89;56
37;37;2018-09-26 23:22:06.487;2018-09-27 00:42:00.253;80;31;89;58
36;36;2018-09-27 23:49:03.570;2018-09-28 01:13:35.350;84;33;89;56
32;32;2017-12-28 22:42:25.140;2017-12-29 01:10:43.487;148;34;89;55
32;32;2017-12-30 10:16:02.877;2018-01-02 11:31:23.180;4395;47;79;32
32;32;2018-01-02 03:34:38.740;2018-01-02 11:31:23.180;477;46;79;33
32;32;2018-01-02 10:06:12.677;2018-01-02 11:31:23.180;85;33;79;46
32;32;2018-01-03 07:07:52.790;2018-01-03 07:11:17.783;4;54;56;2
32;32;2018-01-04 06:33:35.333;2018-01-04 08:23:14.027;110;33;89;56
36;36;2018-09-24 22:03:48.397;2018-09-25 00:22:06.137;139;33;89;56
36;36;2018-09-24 22:56:40.350;2018-09-25 00:22:06.137;86;33;89;56
36;36;2018-09-24 18:34:33.010;2018-09-25 00:22:06.137;348;33;89;56
36;36;2018-09-24 20:24:53.470;2018-09-25 00:22:06.137;238;33;89;56
32;32;2018-01-08 13:35:09.947;2018-01-08 15:28:39.243;113;33;89;56
32;32;2018-01-08 13:36:19.037;2018-01-08 15:28:39.243;112;33;89;56
32;32;2018-01-17 11:49:25.110;2018-01-17 14:07:19.840;138;33;89;56
32;32;2018-01-18 11:03:51.223;2018-01-19 10:09:10.813;1386;34;89;55
32;32;2018-01-18 12:40:11.067;2018-01-19 10:09:10.813;1289;70;89;19
32;32;2018-01-21 22:23:38.740;2018-01-22 04:20:07.130;357;29;100;71
32;32;2018-01-29 13:09:40.620;2018-01-29 14:52:02.473;103;40;89;49
36;36;2018-09-20 06:28:42.237;2018-09-20 07:23:39.070;55;32;44;12
35;35;2018-08-22 08:28:15.403;2018-08-22 20:40:39.947;732;34;89;55
34;34;2018-07-30 07:46:56.903;2018-07-30 09:20:33.480;94;32;89;57
35;35;2018-08-24 07:42:22.657;2018-08-24 09:14:19.290;92;34;89;55
35;35;2018-08-25 11:41:47.063;2018-08-25 13:38:14.307;117;32;89;57
34;34;2018-08-27 06:10:48.340;2018-08-27 19:31:56.003;801;34;89;55
34;34;2018-06-05 12:10:12.793;2018-06-05 13:30:56.247;80;34;89;55
35;35;2018-09-06 14:24:54.120;2018-09-06 15:21:10.530;57;33;39;6
35;35;2018-09-07 12:47:51.163;2018-09-07 14:38:39.810;111;34;89;55
35;35;2018-09-07 09:29:06.560;2018-09-07 14:38:39.810;309;41;89;48
34;34;2018-06-20 11:27:04.933;2018-06-20 13:06:41.097;99;34;89;55
32;32;2018-09-28 21:10:00.303;2018-09-28 22:52:16.223;102;33;89;56
35;35;2018-09-10 01:14:54.620;2018-09-10 02:53:12.010;99;34;89;55
35;35;2018-09-12 07:30:47.173;2018-09-12 08:58:53.260;88;33;89;56
32;32;2018-09-07 08:22:14.857;2018-09-07 15:40:07.833;438;22;34;12
35;35;2018-09-14 18:03:15.587;2018-09-14 19:20:47.267;77;33;89;56
34;34;2018-06-21 11:41:25.910;2018-06-21 13:39:04.343;118;33;48;15
34;34;2018-06-21 11:42:32.967;2018-06-21 13:39:04.343;117;33;48;15
32;32;2018-08-24 07:56:39.263;2018-08-24 09:20:47.687;84;33;84;51
35;35;2018-09-18 12:03:03.693;2018-09-18 14:00:07.163;117;33;89;56
32;32;2018-08-20 23:37:02.683;2018-08-21 00:57:54.327;80;34;89;55
35;35;2018-09-20 05:05:07.130;2018-09-20 06:26:31.960;81;34;89;55
35;35;2018-09-20 20:26:37.290;2018-09-20 21:46:49.853;80;33;89;56
32;32;2018-08-17 18:04:04.593;2018-08-17 19:29:58.063;85;33;89;56
34;34;2018-06-26 20:16:50.280;2018-06-26 21:46:01.190;90;34;89;55
35;35;2018-09-25 11:56:30.370;2018-09-25 17:54:45.320;358;34;100;66
32;32;2018-08-07 06:02:17.007;2018-08-07 07:27:18.183;85;34;89;55
32;32;2018-08-03 04:56:28.137;2018-08-03 05:16:16.277;20;32;47;15
35;35;2018-09-28 13:44:38.197;2018-09-28 15:08:44.753;84;34;89;55
32;32;2018-08-03 07:49:36.593;2018-08-03 09:09:08.523;80;34;89;55
35;35;2018-08-12 22:26:35.950;2018-08-13 01:28:17.450;182;2;96;94
35;35;2018-08-12 22:28:35.877;2018-08-13 01:28:17.450;180;1;96;95
35;35;2018-08-12 22:44:30.477;2018-08-13 01:28:17.450;164;0;96;96
34;34;2018-07-18 12:04:13.420;2018-07-18 12:11:19.260;7;34;35;1
32;32;2018-07-31 09:29:38.323;2018-07-31 10:18:38.457;49;53;79;26
32;32;2018-07-19 11:19:15.587;2018-07-19 12:41:11.397;82;34;89;55
34;34;2018-07-18 12:59:27.820;2018-07-18 13:05:49.977;6;64;68;4
34;34;2018-07-18 21:34:09.697;2018-07-18 22:51:44.657;77;33;89;56
32;32;2018-07-17 16:57:48.160;2018-07-17 18:20:33.773;83;33;89;56
35;35;2018-08-30 20:36:52.810;2018-08-30 21:53:51.823;77;33;89;56
35;35;2018-09-04 02:07:38.337;2018-09-04 03:28:21.970;81;34;89;55
34;34;2018-07-30 21:44:15.497;2018-07-30 23:25:59.793;101;34;89;55
35;35;2018-09-04 17:05:34.253;2018-09-04 18:29:01.530;84;33;89;56
32;32;2018-06-26 13:59:00.540;2018-06-26 16:07:08.067;128;33;89;56
32;32;2018-06-26 14:00:11.880;2018-06-26 16:07:08.067;127;33;89;56
32;32;2018-06-26 14:03:46.147;2018-06-26 16:07:08.067;124;33;89;56
34;34;2018-08-02 13:12:16.663;2018-08-02 14:29:33.563;77;33;89;56
32;32;2018-06-04 05:41:00.147;2018-06-05 06:41:49.297;1500;33;89;56
32;32;2018-06-01 14:23:54.713;2018-06-01 15:37:08.987;74;34;89;55
32;32;2018-05-30 14:26:35.397;2018-05-30 15:38:07.933;72;33;89;56
34;34;2018-09-09 22:47:12.063;2018-09-10 05:11:53.670;384;22;89;67
34;34;2018-09-09 22:47:13.157;2018-09-10 05:11:53.670;384;22;89;67
32;32;2018-05-28 09:49:48.640;2018-05-28 11:33:33.743;104;34;89;55
32;32;2018-05-14 07:46:47.420;2018-05-14 09:04:31.803;78;33;89;56
32;32;2018-05-11 09:19:53.280;2018-05-11 12:49:41.370;210;32;33;1
34;34;2018-09-13 08:12:31.193;2018-09-13 10:41:38.800;149;29;89;60
34;34;2018-09-13 08:13:25.530;2018-09-13 10:41:38.800;148;28;89;61
34;34;2018-09-13 09:08:36.770;2018-09-13 10:41:38.800;93;26;89;63
37;37;2018-09-04 16:15:47.417;2018-09-04 17:36:56.200;81;33;89;56
32;32;2018-05-23 19:53:16.413;2018-05-23 21:26:25.963;93;34;89;55
34;34;2018-09-18 13:05:20.680;2018-09-18 14:31:40.067;86;34;89;55
32;32;2018-05-23 03:50:17.990;2018-05-23 05:21:29.683;91;33;89;56
34;34;2018-09-20 20:50:51.917;2018-09-20 22:18:45.047;88;31;89;58
32;32;2018-05-17 08:26:41.557;2018-05-17 09:50:20.910;84;33;89;56
34;34;2018-09-21 11:42:16.540;2018-09-21 12:52:37.150;70;45;89;44
34;34;2018-09-24 21:14:49.877;2018-09-25 20:49:17.810;1415;31;84;53
34;34;2018-09-25 19:20:26.590;2018-09-25 20:49:17.810;89;33;84;51
34;34;2018-09-25 19:26:38.087;2018-09-25 20:49:17.810;83;33;84;51
37;37;2018-08-27 21:59:53.193;2018-08-28 10:49:53.400;770;33;62;29
37;37;2018-08-27 22:03:13.593;2018-08-28 10:49:53.400;766;33;62;29
34;34;2018-09-27 08:12:23.187;2018-09-27 09:29:29.847;77;34;86;52
37;37;2018-08-13 13:12:07.190;2018-08-13 14:50:02.377;98;34;89;55
34;34;2018-08-28 20:34:15.260;2018-08-28 22:02:24.627;88;32;89;57
34;34;2018-08-29 23:39:37.590;2018-08-30 00:46:06.570;67;33;65;32
32;32;2018-03-23 11:32:22.163;2018-03-23 13:00:06.090;88;33;89;56
34;34;2018-08-30 20:22:53.153;2018-08-30 21:35:27.247;73;34;89;55
32;32;2018-03-22 05:11:50.080;2018-03-22 06:38:07.867;87;31;89;58
32;32;2018-04-05 10:05:33.817;2018-04-05 11:19:29.700;74;34;89;55
32;32;2018-03-15 06:18:38.610;2018-03-15 08:25:25.660;127;34;89;55
34;34;2018-09-03 08:49:53.197;2018-09-03 17:35:51.180;526;34;89;55
34;34;2018-09-03 10:45:59.490;2018-09-03 17:35:51.180;410;34;89;55
34;34;2018-09-03 12:04:25.420;2018-09-03 17:35:51.180;331;34;89;55
34;34;2018-09-03 12:05:43.150;2018-09-03 17:35:51.180;330;34;89;55
34;34;2018-09-05 03:56:12.583;2018-09-05 05:15:58.263;79;33;89;56
32;32;2018-02-21 03:04:57.660;2018-02-21 05:32:38.407;148;33;89;56
32;32;2018-02-21 03:49:28.170;2018-02-21 05:32:38.407;103;33;89;56
32;32;2017-12-16 05:57:23.533;2017-12-16 11:17:54.837;320;33;100;67
32;32;2017-12-18 11:00:22.083;2017-12-18 11:17:18.953;17;34;39;5
36;36;2018-09-04 01:55:07.313;2018-09-04 03:44:08.090;109;31;89;58
32;32;2018-03-06 12:48:58.720;2018-03-06 13:06:56.340;18;83;89;6
32;32;2018-03-07 09:27:48.703;2018-03-07 09:34:40.180;7;43;44;1
32;32;2018-03-07 09:29:03.120;2018-03-07 09:34:40.180;5;43;44;1
36;36;2018-08-29 22:15:37.827;2018-08-29 23:57:08.900;102;30;89;59
32;32;2017-12-20 11:52:15.613;2017-12-20 12:34:55.467;42;34;54;20
32;32;2017-12-20 12:35:36.303;2017-12-20 13:42:14.387;67;54;89;35
32;32;2017-12-19 07:55:52.993;2017-12-19 09:19:10.540;84;34;77;43
36;36;2018-09-07 08:27:53.237;2018-09-12 07:28:38.813;7141;33;86;53
36;36;2018-09-27 23:39:53.740;2018-09-28 01:13:35.350;94;33;89;56
32;32;2017-12-22 14:52:51.470;2017-12-22 16:52:56.060;120;34;89;55
36;36;2018-09-27 04:10:29.383;2018-09-27 05:53:28.063;103;34;91;57
32;32;2017-12-27 08:27:48.793;2017-12-27 10:47:45.717;140;34;89;55
36;36;2018-09-26 09:34:16.980;2018-09-26 11:05:53.130;91;34;89;55
32;32;2018-01-02 21:43:09.087;2018-01-02 22:43:47.697;60;33;64;31
36;36;2018-09-24 18:46:38.423;2018-09-25 00:22:06.137;336;33;89;56
32;32;2018-01-09 07:59:14.083;2018-01-09 10:01:27.870;122;34;89;55
32;32;2018-01-10 06:50:23.820;2018-01-10 08:44:05.270;114;34;89;55
32;32;2018-01-16 14:26:53.497;2018-01-16 16:38:23.210;132;34;89;55
32;32;2018-01-17 11:13:57.597;2018-01-17 14:07:19.840;174;33;89;56
32;32;2018-01-19 07:37:33.850;2018-01-19 10:09:10.813;152;34;89;55
36;36;2018-09-23 22:46:17.723;2018-09-24 00:43:34.120;117;28;88;60
32;32;2018-01-22 23:25:18.473;2018-01-23 01:06:19.983;101;34;89;55
32;32;2018-01-25 17:44:26.387;2018-01-25 19:36:32.857;112;33;89;56
32;32;2018-01-26 20:01:44.370;2018-01-26 21:56:56.183;115;33;89;56
32;32;2018-01-30 08:48:30.913;2018-01-30 10:54:14.180;126;34;89;55
32;32;2018-02-01 06:46:27.793;2018-02-01 09:14:06.100;148;34;89;55
32;32;2018-02-01 06:55:31.327;2018-02-01 09:14:06.100;139;34;89;55
32;32;2018-02-03 13:01:05.790;2018-02-03 18:30:32.860;329;53;100;47
32;32;2018-02-15 15:01:47.930;2018-02-15 16:23:10.933;82;33;89;56
32;32;2018-02-02 05:43:03.387;2018-02-02 08:09:25.967;146;34;89;55
32;32;2017-11-06 12:04:52.037;2017-11-06 22:28:29.730;624;34;89;55
32;32;2017-11-06 12:09:56.533;2017-11-06 22:28:29.730;619;34;89;55
32;32;2017-11-06 12:12:31.613;2017-11-06 22:28:29.730;616;34;89;55
32;32;2017-11-06 21:00:06.557;2017-11-06 22:28:29.730;88;28;89;61
32;32;2017-11-06 05:27:31.653;2017-11-06 22:28:29.730;1021;33;89;56
36;36;2018-09-20 04:37:45.087;2018-09-20 07:23:39.070;166;32;44;12
32;32;2017-11-07 17:49:01.633;2017-11-07 18:50:08.060;61;34;89;55
32;32;2017-10-31 07:31:32.170;2017-11-01 01:13:28.410;1062;99;100;1
32;32;2017-11-08 11:09:29.850;2017-11-08 12:00:14.437;51;33;81;48
32;32;2017-12-19 16:26:58.740;2017-12-19 18:14:36.740;108;34;89;55
32;32;2017-12-22 04:04:46.620;2017-12-22 04:54:39.870;50;34;56;22
32;32;2017-12-22 04:56:11.183;2017-12-22 16:52:56.060;716;56;89;33
32;32;2017-12-26 13:29:28.063;2017-12-26 15:43:17.290;134;33;89;56
36;36;2018-09-24 21:16:36.303;2018-09-25 00:22:06.137;186;33;89;56
36;36;2018-09-24 22:58:42.540;2018-09-25 00:22:06.137;84;33;89;56
36;36;2018-09-24 21:16:25.090;2018-09-25 00:22:06.137;186;33;89;56
32;32;2018-01-03 11:28:34.953;2018-01-03 13:16:38.900;108;34;89;55
32;32;2018-01-05 06:11:59.183;2018-01-05 08:09:54.997;118;32;89;57
36;36;2018-09-21 07:30:14.927;2018-09-21 08:59:02.470;89;34;89;55
32;32;2018-01-11 06:38:24.870;2018-01-11 08:39:33.723;121;33;89;56
32;32;2018-01-12 09:24:22.293;2018-01-12 11:26:41.303;122;34;89;55
32;32;2018-01-15 12:54:22.093;2018-01-15 15:01:09.820;127;34;89;55
32;32;2018-01-17 11:46:13.193;2018-01-17 14:07:19.840;141;33;89;56
36;36;2018-09-23 22:37:40.480;2018-09-24 00:43:34.120;126;28;88;60
32;32;2018-01-23 20:47:46.120;2018-01-23 22:35:23.907;108;34;89;55
32;32;2018-01-24 16:59:12.443;2018-01-24 18:44:31.807;105;34;89;55
32;32;2018-01-31 06:48:55.290;2018-01-31 08:58:47.493;130;34;89;55
32;32;2018-02-02 05:40:49.653;2018-02-02 08:09:25.967;149;34;89;55
32;32;2018-02-16 12:15:46.137;2018-02-16 13:39:35.703;84;34;89;55
32;32;2018-02-21 23:23:09.373;2018-02-22 00:35:30.667;72;34;89;55
32;32;2017-12-15 05:58:52.200;2017-12-15 07:35:59.320;97;33;76;43
32;32;2017-11-06 12:11:29.463;2017-11-06 22:28:29.730;617;34;89;55
36;36;2018-09-20 07:01:25.097;2018-09-20 07:23:39.070;22;34;44;10
36;36;2018-09-19 06:11:20.453;2018-09-19 07:33:46.637;82;33;89;56
32;32;2017-11-08 12:02:35.830;2017-11-08 12:11:20.230;9;81;89;8
32;32;2017-11-10 17:16:02.873;2017-11-10 18:19:07.017;63;33;89;56
32;32;2017-11-13 16:05:28.550;2017-11-13 17:12:33.723;67;32;89;57
32;32;2017-11-14 18:25:36.337;2017-11-14 19:32:58.997;67;34;89;55
32;32;2017-11-15 12:01:14.857;2017-11-15 13:07:59.693;66;34;89;55
32;32;2017-11-16 06:42:01.547;2017-11-16 07:52:59.373;70;31;89;58
32;32;2017-11-20 09:03:16.373;2017-11-20 10:06:41.643;63;34;89;55
36;36;2018-09-17 12:15:07.703;2018-09-17 12:33:21.000;18;62;74;12
32;32;2017-11-29 10:30:26.803;2017-11-29 12:12:19.630;102;33;89;56
32;32;2017-11-28 03:54:54.543;2017-11-28 07:00:11.283;186;33;100;67
36;36;2018-09-06 15:39:01.633;2018-09-06 17:02:41.960;83;34;89;55
32;32;2017-12-01 08:14:38.923;2017-12-01 09:59:35.240;105;33;89;56
36;36;2018-08-23 19:48:55.220;2018-08-23 21:28:23.723;100;34;89;55
32;32;2017-12-13 13:39:58.003;2017-12-13 16:25:36.150;166;33;89;56
32;32;2018-02-07 08:09:37.080;2018-02-07 10:02:45.380;113;34;89;55
36;36;2018-08-24 21:26:51.910;2018-08-24 22:56:21.660;90;34;89;55
32;32;2018-02-28 14:56:04.430;2018-02-28 16:24:11.387;88;34;89;55
36;36;2018-08-06 12:13:16.807;2018-08-06 14:46:57.700;153;34;89;55
36;36;2018-08-16 21:30:16.707;2018-08-16 23:04:14.700;94;34;89;55
36;36;2018-08-20 12:09:39.563;2018-08-20 14:23:37.757;134;33;89;56
36;36;2018-08-02 20:58:11.687;2018-08-02 22:36:36.313;98;34;89;55
36;36;2018-08-01 17:06:32.723;2018-08-01 18:50:08.387;104;33;89;56
36;36;2018-08-01 17:08:52.863;2018-08-01 18:50:08.387;102;33;89;56
36;36;2018-08-01 17:15:18.780;2018-08-01 18:50:08.387;95;33;89;56
36;36;2018-07-19 21:10:18.563;2018-07-20 10:05:16.453;775;34;89;55
36;36;2018-07-30 21:36:18.740;2018-07-30 23:00:21.837;84;33;89;56
36;36;2018-07-18 06:35:56.737;2018-07-18 08:03:44.963;88;34;89;55
36;36;2018-07-17 10:11:55.250;2018-07-18 08:03:44.963;1312;34;89;55
36;36;2018-07-19 06:33:54.493;2018-07-19 07:28:03.423;55;33;71;38
36;36;2018-07-13 10:43:29.480;2018-07-13 12:42:24.590;119;33;89;56
36;36;2018-07-13 04:53:13.897;2018-07-13 05:45:32.753;52;34;42;8
32;32;2017-10-04 07:49:27.587;2017-10-04 08:55:16.067;66;34;89;55
32;32;2017-10-05 12:16:39.153;2017-10-05 14:54:10.017;158;39;89;50
32;32;2017-10-05 13:45:37.543;2017-10-05 14:54:10.017;69;34;89;55
32;32;2017-10-06 07:19:52.917;2017-10-06 08:35:18.973;76;34;89;55
36;36;2018-06-27 13:08:05.450;2018-06-27 15:10:31.773;122;34;89;55
36;36;2018-06-27 13:27:28.400;2018-06-27 15:10:31.773;103;34;89;55
36;36;2018-06-28 07:30:10.300;2018-06-28 09:01:25.113;91;33;89;56
36;36;2018-07-25 08:29:54.437;2018-07-25 12:09:18.243;220;76;100;24
36;36;2018-07-25 08:40:12.047;2018-07-25 12:09:18.243;209;76;100;24
32;32;2017-10-09 22:36:19.860;2017-10-09 23:35:20.467;59;33;89;56
32;32;2017-10-13 08:30:42.467;2017-10-13 11:20:59.810;170;34;89;55
32;32;2017-10-13 11:27:08.080;2017-10-13 11:27:42.237;0;88;89;1
32;32;2017-10-17 17:55:41.203;2017-10-17 19:03:46.500;68;34;89;55
32;32;2017-10-17 18:01:40.467;2017-10-17 19:03:46.500;62;34;89;55
32;32;2017-10-18 11:32:04.933;2017-10-18 12:36:34.953;64;33;89;56
32;32;2017-10-20 03:41:01.510;2017-10-20 04:53:47.550;72;28;89;61
32;32;2017-10-20 03:42:48.690;2017-10-20 04:53:47.550;71;28;89;61
32;32;2017-10-24 06:42:20.297;2017-10-24 07:56:51.743;74;34;88;54
32;32;2017-10-24 21:34:46.013;2017-10-24 23:00:44.670;86;33;89;56
32;32;2017-10-24 21:36:18.837;2017-10-24 23:00:44.670;84;33;89;56
32;32;2017-10-23 06:16:36.907;2017-10-23 07:33:17.830;77;31;89;58
32;32;2017-10-23 06:18:04.700;2017-10-23 07:33:17.830;75;31;89;58
32;32;2017-10-25 16:24:59.083;2017-10-25 17:39:06.257;75;33;89;56
32;32;2017-10-26 13:47:06.410;2017-10-26 15:05:06.477;78;34;89;55
32;32;2017-10-29 22:07:32.103;2017-10-30 10:02:08.873;715;26;85;59
32;32;2017-10-29 22:14:55.377;2017-10-30 10:02:08.873;708;25;85;60
36;36;2018-06-20 10:53:40.557;2018-06-20 11:49:59.537;56;33;68;35
36;36;2018-06-05 19:12:37.150;2018-06-05 20:43:01.610;91;33;89;56
36;36;2018-08-09 19:58:18.887;2018-08-09 21:43:52.180;105;34;89;55
36;36;2018-08-14 03:12:50.460;2018-08-14 05:38:48.110;146;34;89;55
36;36;2018-07-30 03:39:04.120;2018-07-30 05:33:46.740;114;33;100;67
36;36;2018-07-25 06:40:19.203;2018-07-25 08:25:52.907;105;33;76;43
36;36;2018-06-18 16:47:09.820;2018-06-18 21:43:24.577;296;33;100;67
36;36;2018-07-02 08:54:56.650;2018-07-02 10:34:46.370;100;34;89;55
36;36;2018-07-03 08:52:00.470;2018-07-03 10:52:04.480;120;33;89;56
36;36;2018-06-07 12:17:27.287;2018-06-07 14:01:12.213;104;34;89;55
36;36;2018-06-13 13:47:59.440;2018-06-13 15:25:59.140;98;33;89;56
36;36;2018-06-14 10:48:51.113;2018-06-14 12:38:34.167;110;34;92;58
36;36;2018-06-06 12:54:19.030;2018-06-06 14:19:09.797;85;33;89;56
36;36;2018-05-24 13:49:54.630;2018-05-24 16:54:05.337;185;33;89;56
36;36;2018-05-22 02:47:51.640;2018-05-22 04:28:51.193;101;32;89;57
36;36;2018-05-17 14:32:09.700;2018-05-17 15:54:07.053;82;34;89;55
36;36;2018-04-30 23:07:18.913;2018-05-01 02:21:12.980;194;33;89;56
36;36;2018-04-21 04:09:33.520;2018-04-21 05:40:55.740;91;31;89;58
36;36;2018-03-27 19:50:06.773;2018-03-27 21:48:13.237;118;34;89;55
36;36;2018-04-18 07:49:58.670;2018-04-18 09:02:30.007;73;34;78;44
36;36;2018-03-26 02:27:46.943;2018-03-26 03:56:46.520;89;33;89;56
36;36;2018-06-01 04:46:22.147;2018-06-01 08:34:12.143;228;34;89;55
36;36;2018-05-28 15:07:07.437;2018-05-28 16:32:32.970;85;34;89;55
36;36;2018-05-30 07:29:16.500;2018-05-30 09:12:36.740;103;33;89;56
36;36;2018-05-08 23:16:46.793;2018-05-09 00:40:23.230;84;33;89;56
36;36;2018-05-08 09:44:15.093;2018-05-08 11:01:33.400;77;34;89;55
36;36;2018-04-10 13:36:21.260;2018-04-10 14:54:53.817;78;34;82;48
36;36;2018-04-04 15:08:19.620;2018-04-04 16:45:49.417;97;33;89;56
36;36;2018-04-05 11:25:34.590;2018-04-05 13:23:56.097;118;34;89;55
36;36;2018-02-15 02:15:14.780;2018-02-15 03:50:03.353;95;34;89;55
36;36;2018-04-02 16:55:56.560;2018-04-02 18:19:43.010;84;34;89;55
36;36;2018-02-13 08:09:09.077;2018-02-13 09:35:54.717;86;34;89;55
36;36;2018-02-06 10:33:55.807;2018-02-06 11:45:31.870;72;34;66;32
36;36;2018-02-11 22:45:09.657;2018-02-12 03:53:27.953;308;4;100;96
36;36;2018-02-08 08:54:50.140;2018-02-08 10:39:02.113;105;34;82;48
36;36;2018-02-08 10:40:47.110;2018-02-08 10:58:27.937;18;82;89;7
36;36;2018-02-06 20:31:16.493;2018-02-06 22:31:15.393;120;33;89;56
36;36;2018-02-01 02:13:35.717;2018-02-01 04:19:16.120;126;33;89;56
36;36;2018-02-01 18:16:54.643;2018-02-01 20:22:34.393;126;34;89;55
36;36;2018-02-01 18:22:40.343;2018-02-01 20:22:34.393;120;34;89;55
36;36;2018-02-03 05:40:41.157;2018-02-03 07:55:54.043;135;32;89;57
36;36;2018-02-03 05:40:43.573;2018-02-03 07:55:54.043;135;32;89;57
36;36;2018-01-25 15:11:16.993;2018-01-25 17:38:54.030;147;33;89;56
36;36;2018-01-26 15:26:12.680;2018-01-26 18:43:25.000;197;34;89;55
36;36;2018-01-19 09:59:05.127;2018-01-19 11:53:28.250;114;33;89;56
36;36;2018-09-22 11:30:32.390;2018-09-22 11:46:02.277;16;32;33;1
36;36;2018-09-22 11:31:41.967;2018-09-22 11:46:02.277;15;32;33;1
32;32;2018-01-18 12:37:25.810;2018-01-19 10:09:10.813;1292;70;89;19
32;32;2018-01-29 12:48:43.107;2018-01-29 13:07:30.587;19;34;40;6
32;32;2018-01-31 06:43:07.683;2018-01-31 08:58:47.493;135;34;89;55
36;36;2018-09-19 21:48:57.900;2018-09-20 07:23:39.070;575;33;44;11
32;32;2018-02-20 07:24:00.997;2018-02-20 08:58:07.970;94;33;89;56
32;32;2018-02-21 23:17:49.807;2018-02-22 00:35:30.667;78;34;89;55
32;32;2017-11-06 11:59:48.357;2017-11-06 22:28:29.730;629;34;89;55
32;32;2017-11-06 12:07:25.700;2017-11-06 22:28:29.730;621;34;89;55
32;32;2017-11-06 12:08:42.397;2017-11-06 22:28:29.730;620;34;89;55
32;32;2017-11-06 20:58:26.370;2017-11-06 22:28:29.730;90;30;89;59
32;32;2017-11-06 21:02:32.743;2017-11-06 22:28:29.730;86;28;89;61
36;36;2018-09-20 07:24:06.113;2018-09-20 12:54:22.157;330;44;89;45
32;32;2017-10-31 20:18:52.820;2017-11-01 01:13:28.410;295;34;100;66
32;32;2017-11-08 11:05:27.657;2017-11-08 12:00:14.437;55;33;81;48
32;32;2017-11-08 11:07:55.463;2017-11-08 12:00:14.437;53;33;81;48
32;32;2017-11-09 23:52:15.787;2017-11-10 01:06:43.140;74;33;89;56
32;32;2017-11-09 23:56:01.420;2017-11-10 01:06:43.140;70;33;89;56
32;32;2017-11-10 00:05:09.977;2017-11-10 01:06:43.140;61;33;89;56
32;32;2017-11-14 18:21:55.080;2017-11-14 19:32:58.997;71;34;89;55
32;32;2017-11-16 06:38:39.993;2017-11-16 07:52:59.373;74;31;89;58
32;32;2017-11-16 21:30:46.373;2017-11-16 22:41:18.613;71;33;89;56
32;32;2017-11-21 13:44:16.780;2017-11-21 14:53:17.590;69;34;89;55
32;32;2017-11-22 08:24:52.390;2017-11-22 09:35:20.817;71;34;89;55
36;36;2018-09-17 11:20:59.250;2018-09-17 12:13:44.190;53;33;62;29
36;36;2018-09-14 06:58:10.820;2018-09-14 12:31:24.510;333;34;100;66
32;32;2017-11-23 20:47:17.603;2017-11-23 22:03:33.447;76;34;93;59
32;32;2017-11-27 07:23:05.873;2017-11-27 12:38:50.250;315;34;99;65
36;36;2018-09-13 01:42:56.013;2018-09-13 05:19:23.697;217;33;93;60
36;36;2018-08-25 06:35:05.803;2018-08-25 08:01:38.350;86;80;89;9
36;36;2018-08-25 07:34:03.770;2018-08-25 08:01:38.350;27;76;89;13
36;36;2018-08-25 07:34:54.907;2018-08-25 08:01:38.350;27;76;89;13
36;36;2018-08-25 07:35:42.150;2018-08-25 08:01:38.350;26;76;89;13
36;36;2018-08-23 19:38:27.453;2018-08-23 21:28:23.723;110;34;89;55
32;32;2017-12-07 09:02:39.723;2017-12-07 10:54:35.873;112;33;89;56
32;32;2017-12-11 10:05:52.497;2017-12-11 12:23:32.463;138;33;89;56
32;32;2018-02-06 10:59:28.160;2018-02-06 12:44:03.007;105;33;89;56
32;32;2018-02-08 03:13:53.900;2018-02-08 05:05:27.980;112;33;89;56
36;36;2018-08-24 14:31:13.650;2018-08-24 21:26:45.147;415;33;34;1
32;32;2018-02-13 04:49:08.310;2018-02-13 05:47:47.140;58;43;89;46
36;36;2018-08-07 07:30:14.840;2018-08-07 11:07:19.450;217;34;89;55
36;36;2018-08-21 06:40:27.623;2018-08-21 09:42:55.607;182;34;89;55
36;36;2018-08-22 09:22:05.880;2018-08-22 11:51:06.070;149;34;99;65
36;36;2018-08-22 10:14:43.100;2018-08-22 11:51:06.070;97;34;99;65
36;36;2018-08-02 20:29:57.333;2018-08-02 22:36:36.313;127;34;89;55
36;36;2018-07-31 14:49:44.023;2018-07-31 16:23:43.380;94;34;89;55
36;36;2018-07-18 06:32:36.800;2018-07-18 08:03:44.963;91;34;89;55
36;36;2018-07-19 06:30:32.447;2018-07-19 07:28:03.423;58;33;71;38
36;36;2018-07-16 13:15:00.337;2018-07-16 15:58:22.820;163;34;89;55
36;36;2018-07-13 04:34:57.670;2018-07-13 05:45:32.753;71;34;42;8
36;36;2018-07-13 04:52:02.053;2018-07-13 05:45:32.753;53;34;42;8
36;36;2018-07-13 05:15:24.593;2018-07-13 05:45:32.753;30;34;42;8
32;32;2018-03-05 16:05:19.477;2018-03-05 17:34:35.550;89;33;89;56
32;32;2017-10-02 06:48:24.237;2017-10-02 09:29:16.850;161;30;80;50
32;32;2017-10-05 13:42:20.300;2017-10-05 14:54:10.017;72;34;89;55
32;32;2017-10-09 10:29:48.433;2017-10-09 11:48:14.290;79;34;89;55
32;32;2017-10-09 10:36:59.610;2017-10-09 11:48:14.290;72;34;89;55
36;36;2018-06-27 13:05:42.517;2018-06-27 15:10:31.773;125;34;89;55
36;36;2018-06-25 17:28:27.470;2018-06-25 21:34:45.647;246;34;91;57
36;36;2018-06-25 17:29:07.900;2018-06-25 21:34:45.647;245;34;91;57
32;32;2017-10-09 22:38:22.977;2017-10-09 23:35:20.467;57;33;89;56
32;32;2017-10-11 15:37:40.843;2017-10-11 16:37:14.273;60;34;89;55
32;32;2017-10-10 11:17:59.137;2017-10-10 12:17:19.483;60;34;89;55
32;32;2017-10-13 08:37:18.027;2017-10-13 11:20:59.810;163;34;89;55
32;32;2017-10-13 13:06:31.530;2017-10-13 13:08:55.250;2;87;89;2
32;32;2017-10-16 09:02:33.390;2017-10-16 09:44:56.843;42;34;73;39
32;32;2017-10-17 17:53:50.350;2017-10-17 19:03:46.500;70;34;89;55
32;32;2017-10-17 12:58:41.583;2017-10-17 19:03:46.500;365;34;89;55
32;32;2017-10-18 11:25:33.393;2017-10-18 12:36:34.953;71;33;89;56
32;32;2017-10-19 07:29:20.130;2017-10-19 08:34:36.570;65;33;89;56
36;36;2018-08-27 15:19:46.073;2018-08-27 16:38:55.773;79;33;89;56
32;32;2017-10-24 21:46:58.373;2017-10-24 23:00:44.670;74;33;89;56
32;32;2017-10-23 06:04:52.360;2017-10-23 07:33:17.830;89;31;89;58
32;32;2017-10-25 16:24:12.230;2017-10-25 17:39:06.257;75;33;89;56
32;32;2017-10-25 16:26:07.197;2017-10-25 17:39:06.257;73;33;89;56
36;36;2018-08-08 04:58:59.597;2018-08-08 09:09:38.777;251;34;92;58
36;36;2018-08-10 14:53:30.710;2018-08-10 16:31:58.433;98;34;89;55
36;36;2018-07-25 07:02:29.420;2018-07-25 08:25:52.907;83;33;76;43
36;36;2018-07-25 07:08:18.490;2018-07-25 08:25:52.907;77;33;76;43
36;36;2018-07-25 07:18:23.263;2018-07-25 08:25:52.907;67;33;76;43
36;36;2018-07-06 22:53:25.937;2018-07-07 00:24:24.973;91;33;89;56
36;36;2018-07-04 06:53:42.187;2018-07-04 09:29:44.190;156;34;89;55
36;36;2018-06-10 22:33:41.420;2018-06-11 03:23:29.023;290;28;100;72
36;36;2018-06-12 14:25:34.000;2018-06-12 17:16:08.507;171;34;89;55
36;36;2018-06-06 12:52:55.963;2018-06-06 14:19:09.797;87;33;89;56
36;36;2018-05-25 11:06:50.577;2018-05-25 12:41:56.963;95;34;92;58
36;36;2018-05-25 11:13:24.110;2018-05-25 12:41:56.963;88;34;92;58
36;36;2018-05-23 14:33:45.597;2018-05-23 16:44:08.727;131;33;89;56
36;36;2018-05-18 10:39:49.460;2018-05-21 02:50:07.263;3851;33;89;56
36;36;2018-05-16 09:49:11.607;2018-05-16 12:10:30.010;141;34;89;55
36;36;2018-04-26 16:25:32.950;2018-04-26 18:07:20.440;102;33;89;56
36;36;2018-04-26 11:20:14.153;2018-04-26 18:07:20.440;407;34;89;55
36;36;2018-04-24 11:17:09.177;2018-04-24 12:43:05.670;86;34;89;55
36;36;2018-04-20 03:40:36.267;2018-04-20 05:32:00.643;112;33;89;56
36;36;2018-04-17 12:56:04.323;2018-04-17 13:57:02.140;61;60;88;28
36;36;2018-03-23 07:02:48.333;2018-03-23 08:33:25.233;91;31;89;58
36;36;2018-05-31 06:28:44.017;2018-05-31 08:41:51.043;133;33;89;56
36;36;2018-05-11 06:28:38.283;2018-05-11 08:00:28.570;92;34;89;55
36;36;2018-05-26 22:02:34.920;2018-05-27 04:49:50.633;407;43;100;57
36;36;2018-05-26 23:57:08.863;2018-05-27 04:49:50.633;292;43;100;57
36;36;2018-05-10 12:11:20.510;2018-05-10 21:00:31.390;529;34;48;14
36;36;2018-05-10 12:37:17.190;2018-05-10 21:00:31.390;503;34;48;14
36;36;2018-05-10 12:41:06.313;2018-05-10 21:00:31.390;499;34;48;14
36;36;2018-05-10 12:45:04.203;2018-05-10 21:00:31.390;495;34;48;14
36;36;2018-05-10 20:26:17.513;2018-05-10 21:00:31.390;34;33;48;15
36;36;2018-05-07 10:24:00.000;2018-05-07 11:59:45.110;95;33;89;56
36;36;2018-05-07 10:29:35.167;2018-05-07 11:59:45.110;90;33;89;56
36;36;2018-05-03 09:15:26.543;2018-05-03 10:38:50.243;83;34;89;55
36;36;2018-04-11 06:25:33.073;2018-04-11 07:55:13.463;90;34;89;55
36;36;2018-04-06 09:48:57.140;2018-04-06 12:36:58.370;168;33;89;56
36;36;2018-02-14 04:34:01.030;2018-02-14 06:03:43.913;89;33;89;56
36;36;2018-02-09 09:16:53.573;2018-02-09 11:11:04.003;115;34;85;51
36;36;2018-01-29 20:06:36.677;2018-01-29 23:18:03.667;192;33;95;62
36;36;2018-01-24 16:30:54.210;2018-01-24 18:51:42.550;141;33;89;56
36;36;2018-01-22 10:00:14.423;2018-01-23 03:33:49.470;1053;83;89;6
36;36;2018-01-15 07:33:57.817;2018-01-15 09:35:50.890;122;34;89;55
36;36;2018-01-15 07:45:43.323;2018-01-15 09:35:50.890;110;34;89;55
36;36;2018-01-16 23:37:50.447;2018-01-17 01:50:35.567;133;32;89;57
36;36;2018-01-12 02:19:58.607;2018-01-12 04:32:52.027;133;33;89;56
36;36;2018-01-10 07:48:25.547;2018-01-10 10:15:24.693;147;34;89;55
36;36;2018-01-08 23:08:15.477;2018-01-09 01:26:36.173;138;31;89;58
43;43;2018-01-15 09:47:23.710;2018-01-15 12:10:36.190;143;34;89;55
43;43;2018-01-18 07:13:29.303;2018-01-18 10:11:21.387;178;33;89;56
37;37;2018-09-25 09:43:35.057;2018-09-25 10:06:13.440;23;34;44;10
37;37;2018-09-21 00:57:00.277;2018-09-21 02:26:31.633;89;31;89;58
43;43;2017-10-19 18:20:48.320;2017-10-19 19:37:44.710;77;34;89;55
32;32;2018-02-01 23:15:19.067;2018-02-02 08:09:25.967;534;41;89;48
32;32;2018-02-19 10:17:06.870;2018-02-19 11:47:24.530;90;34;89;55
32;32;2018-02-22 15:01:27.650;2018-02-22 16:14:17.287;73;34;89;55
32;32;2017-11-06 21:01:06.480;2017-11-06 22:28:29.730;87;28;89;61
32;32;2017-11-07 17:51:08.650;2017-11-07 18:50:08.060;59;34;89;55
36;36;2018-09-20 11:17:23.960;2018-09-20 12:54:22.157;97;33;89;56
36;36;2018-09-20 11:18:43.820;2018-09-20 12:54:22.157;96;33;89;56
32;32;2017-10-31 20:14:32.447;2017-11-01 01:13:28.410;299;34;100;66
32;32;2017-10-31 20:16:56.987;2017-11-01 01:13:28.410;297;34;100;66
32;32;2017-11-10 01:33:34.350;2017-11-10 18:19:07.017;1006;88;89;1
32;32;2017-11-14 18:20:35.300;2017-11-14 19:32:58.997;72;34;89;55
32;32;2017-11-20 20:40:44.833;2017-11-20 21:47:39.997;67;34;89;55
32;32;2017-11-18 07:10:28.520;2017-11-18 11:57:10.553;287;73;100;27
32;32;2017-11-23 05:04:36.950;2017-11-23 06:18:53.387;74;34;89;55
32;32;2017-11-27 07:07:57.330;2017-11-27 12:38:50.250;331;34;99;65
32;32;2017-11-30 03:17:08.420;2017-11-30 04:58:18.220;101;34;89;55
32;32;2017-11-30 16:20:06.963;2017-11-30 19:40:33.293;200;40;89;49
32;32;2017-12-12 15:15:18.570;2017-12-12 17:43:42.477;148;34;89;55
32;32;2018-02-05 12:22:20.720;2018-02-05 13:54:53.570;92;38;89;51
32;32;2018-02-07 08:17:35.477;2018-02-07 10:02:45.380;105;34;89;55
32;32;2018-02-12 06:35:45.970;2018-02-12 11:27:51.967;292;32;100;68
32;32;2018-02-14 14:32:45.520;2018-02-14 16:01:40.140;89;33;89;56
32;32;2018-02-27 21:34:45.483;2018-02-27 22:52:58.867;78;33;89;56
32;32;2018-02-28 15:04:08.570;2018-02-28 16:24:11.387;80;34;89;55
32;32;2018-03-01 11:11:48.863;2018-03-01 12:44:53.233;93;34;89;55
32;32;2018-03-01 11:16:43.213;2018-03-01 12:44:53.233;88;34;89;55
32;32;2018-03-03 04:13:59.737;2018-03-04 23:31:46.510;2598;31;89;58
32;32;2018-03-04 21:52:04.023;2018-03-04 23:31:46.510;99;31;89;58
36;36;2018-08-17 17:40:50.420;2018-08-17 19:27:53.913;107;33;89;56
36;36;2018-08-02 20:31:22.713;2018-08-02 22:36:36.313;125;34;89;55
36;36;2018-08-01 17:14:14.613;2018-08-01 18:50:08.387;96;33;89;56
36;36;2018-08-01 17:18:46.287;2018-08-01 18:50:08.387;92;33;89;56
36;36;2018-07-31 14:58:13.407;2018-07-31 16:23:43.380;85;34;89;55
36;36;2018-08-01 10:01:16.930;2018-08-01 10:45:35.057;44;34;55;21
36;36;2018-07-20 08:21:58.990;2018-07-20 10:05:16.453;104;33;89;56
36;36;2018-07-19 21:12:25.930;2018-07-20 10:05:16.453;773;34;89;55
36;36;2018-07-17 18:43:22.093;2018-07-18 08:03:44.963;800;33;89;56
36;36;2018-07-19 06:32:24.850;2018-07-19 07:28:03.423;56;33;71;38
36;36;2018-07-16 13:01:38.480;2018-07-16 15:58:22.820;177;34;89;55
36;36;2018-06-22 13:21:22.040;2018-06-22 15:39:03.703;138;34;89;55
36;36;2018-07-13 05:14:06.867;2018-07-13 05:45:32.753;31;34;42;8
36;36;2018-06-27 13:11:14.937;2018-06-27 15:10:31.773;119;34;89;55
36;36;2018-06-21 17:39:37.570;2018-06-21 19:26:03.550;107;34;89;55
32;32;2017-10-02 07:25:53.153;2017-10-02 09:29:16.850;124;29;80;51
32;32;2017-10-02 07:30:12.227;2017-10-02 09:29:16.850;119;29;80;51
32;32;2017-10-03 16:14:41.373;2017-10-03 17:22:14.410;68;34;89;55
32;32;2017-10-02 17:22:27.893;2017-10-02 18:57:28.083;95;34;97;63
32;32;2017-10-02 17:31:39.857;2017-10-02 18:57:28.083;86;34;97;63
32;32;2017-10-04 20:22:38.373;2017-10-04 21:30:56.750;68;34;89;55
32;32;2017-10-11 03:53:49.210;2017-10-11 04:50:37.980;57;34;89;55
36;36;2018-06-19 18:10:48.970;2018-06-19 19:37:06.250;87;34;89;55
32;32;2017-10-16 09:04:57.660;2017-10-16 09:44:56.843;40;34;73;39
32;32;2017-10-17 17:56:42.550;2017-10-17 19:03:46.500;67;34;89;55
32;32;2017-10-17 17:49:50.477;2017-10-17 19:03:46.500;74;34;89;55
32;32;2017-10-24 06:43:44.053;2017-10-24 07:56:51.743;73;34;88;54
32;32;2017-10-24 06:46:42.627;2017-10-24 07:56:51.743;70;34;88;54
32;32;2017-10-23 05:59:57.293;2017-10-23 07:33:17.830;94;31;89;58
32;32;2017-10-26 13:53:44.880;2017-10-26 15:05:06.477;72;34;89;55
36;36;2018-08-09 20:13:23.590;2018-08-09 21:43:52.180;90;34;89;55
36;36;2018-08-13 10:14:48.377;2018-08-13 12:16:43.093;122;34;89;55
36;36;2018-07-27 11:59:20.760;2018-07-27 14:25:11.293;146;32;89;57
36;36;2018-07-27 07:58:45.280;2018-07-27 14:25:11.293;387;33;89;56
36;36;2018-07-25 06:47:22.230;2018-07-25 08:25:52.907;98;33;76;43
36;36;2018-07-25 06:55:03.670;2018-07-25 08:25:52.907;90;33;76;43
36;36;2018-07-22 22:02:31.717;2018-07-24 02:14:20.530;1692;4;33;29
36;36;2018-09-06 02:10:02.103;2018-09-06 03:37:05.700;87;32;89;57
36;36;2018-06-07 09:11:39.897;2018-06-07 14:01:12.213;290;34;89;55
36;36;2018-06-07 12:15:09.260;2018-06-07 14:01:12.213;106;34;89;55
36;36;2018-06-07 12:19:21.717;2018-06-07 14:01:12.213;102;34;89;55
36;36;2018-06-12 15:42:01.453;2018-06-12 17:16:08.507;94;34;89;55
36;36;2018-06-06 12:51:35.737;2018-06-06 14:19:09.797;88;33;89;56
36;36;2018-05-25 11:18:48.890;2018-05-25 12:41:56.963;83;34;92;58
36;36;2018-05-24 13:42:24.463;2018-05-24 16:54:05.337;192;33;89;56
36;36;2018-05-16 09:52:32.360;2018-05-16 12:10:30.010;138;34;89;55
36;36;2018-05-02 12:58:00.273;2018-05-02 16:34:52.733;216;34;91;57
36;36;2018-04-26 16:19:10.033;2018-04-26 18:07:20.440;108;33;89;56
36;36;2018-04-25 04:14:52.430;2018-04-25 05:43:47.383;89;33;89;56
36;36;2018-04-18 07:44:39.670;2018-04-18 09:02:30.007;78;34;78;44
36;36;2018-03-30 18:02:10.403;2018-03-30 21:57:27.250;235;32;89;57
36;36;2018-06-02 01:53:29.653;2018-06-02 04:25:08.997;152;34;91;57
36;36;2018-05-12 05:26:26.660;2018-05-12 07:03:28.470;97;34;89;55
36;36;2018-05-09 15:07:41.710;2018-05-09 16:30:11.363;83;34;89;55
36;36;2018-05-10 12:49:19.060;2018-05-10 21:00:31.390;491;34;48;14
36;36;2018-05-10 12:50:33.993;2018-05-10 21:00:31.390;490;34;48;14
36;36;2018-05-10 12:52:07.680;2018-05-10 21:00:31.390;488;34;48;14
36;36;2018-05-07 10:06:52.720;2018-05-07 11:59:45.110;113;33;89;56
36;36;2018-05-04 15:41:12.233;2018-05-04 17:10:39.740;89;34;89;55
36;36;2018-04-12 01:13:28.067;2018-04-12 02:52:01.313;99;33;89;56
36;36;2018-04-09 22:02:13.270;2018-04-09 23:28:27.097;86;33;89;56
36;36;2018-04-03 20:24:53.763;2018-04-03 21:57:02.017;93;34;89;55
36;36;2018-02-15 02:05:51.347;2018-02-15 03:50:03.353;105;34;89;55
36;36;2018-02-06 10:21:44.880;2018-02-06 11:45:31.870;84;34;66;32
36;36;2018-02-07 15:26:35.417;2018-02-07 17:29:52.713;123;34;89;55
36;36;2018-02-06 11:48:50.620;2018-02-06 22:31:15.393;643;65;89;24
36;36;2018-02-06 20:29:48.100;2018-02-06 22:31:15.393;122;33;89;56
36;36;2018-02-05 07:45:11.853;2018-02-05 12:50:38.270;305;34;100;66
36;36;2018-02-15 18:55:57.337;2018-02-15 20:42:54.570;107;34;89;55
36;36;2018-01-30 19:58:24.580;2018-01-31 00:59:34.300;301;33;100;67
36;36;2018-01-28 23:18:29.147;2018-01-29 02:45:00.333;207;34;97;63
36;36;2018-01-24 16:27:13.047;2018-01-24 18:51:42.550;144;34;89;55
36;36;2018-01-24 16:31:40.993;2018-01-24 18:51:42.550;140;33;89;56
36;36;2018-01-24 16:35:25.963;2018-01-24 18:51:42.550;136;33;89;56
36;36;2018-01-23 01:30:27.877;2018-01-23 03:33:49.470;123;34;89;55
36;36;2018-01-22 08:09:01.590;2018-01-22 09:57:31.330;108;33;83;50
36;36;2018-01-19 09:57:13.980;2018-01-19 11:53:28.250;116;33;89;56
36;36;2018-01-18 09:54:33.520;2018-01-18 11:53:15.650;119;33;89;56
36;36;2018-01-18 09:57:57.993;2018-01-18 11:53:15.650;116;33;89;56
36;36;2018-01-09 15:44:43.390;2018-01-09 17:53:30.070;129;33;89;56
36;36;2018-01-10 08:22:48.947;2018-01-10 10:15:24.693;113;34;89;55
36;36;2018-01-05 07:32:34.617;2018-01-05 09:23:11.550;111;34;89;55
36;36;2018-01-11 06:35:09.337;2018-01-11 08:36:14.537;121;33;89;56
36;36;2018-01-11 06:40:42.253;2018-01-11 08:36:14.537;116;33;89;56
36;36;2018-01-08 08:15:41.153;2018-01-08 09:44:53.930;89;34;76;42
43;43;2018-01-08 04:20:36.157;2018-01-08 06:15:00.800;115;34;89;55
43;43;2018-01-04 20:53:10.353;2018-01-04 22:48:11.127;115;33;89;56
43;43;2018-01-04 20:57:01.080;2018-01-04 22:48:11.127;111;33;89;56
43;43;2018-01-12 07:54:06.217;2018-01-12 10:05:03.207;131;34;89;55
43;43;2018-01-17 10:12:09.343;2018-01-17 11:48:15.447;96;34;80;46
43;43;2018-01-15 09:52:35.323;2018-01-15 12:10:36.190;138;34;89;55
43;43;2018-01-22 22:43:47.720;2018-01-23 00:33:06.767;110;34;89;55
37;37;2018-09-24 08:57:11.757;2018-09-24 17:20:35.953;503;33;89;56
43;43;2018-01-21 22:02:59.347;2018-01-22 03:48:15.217;346;32;99;67
37;37;2018-09-14 22:07:07.990;2018-09-14 23:30:14.543;83;31;89;58
43;43;2018-01-28 21:55:15.000;2018-01-28 23:09:19.027;74;16;37;21
43;43;2018-01-28 21:57:32.780;2018-01-28 23:09:19.027;72;15;37;22
37;37;2018-09-21 19:52:31.893;2018-09-21 21:21:11.120;89;33;89;56
43;43;2018-01-29 19:57:38.160;2018-01-30 00:28:26.777;271;34;100;66
32;32;2017-11-14 06:30:43.187;2017-11-14 07:35:55.963;65;33;89;56
32;32;2017-11-14 18:24:14.790;2017-11-14 19:32:58.997;68;34;89;55
32;32;2017-11-17 18:07:26.610;2017-11-17 19:17:40.803;70;33;89;56
36;36;2018-09-18 10:01:05.680;2018-09-18 10:23:34.497;22;17;26;9
36;36;2018-09-18 10:24:34.207;2018-09-18 12:26:52.083;122;26;89;63
32;32;2017-11-25 06:01:02.820;2017-11-27 12:38:50.250;3277;63;99;36
32;32;2017-11-28 18:15:58.393;2017-11-28 20:00:27.200;105;33;89;56
32;32;2017-11-29 09:28:14.443;2017-11-29 12:12:19.630;164;33;89;56
32;32;2017-11-30 17:55:14.810;2017-11-30 19:40:33.293;105;33;89;56
32;32;2017-12-02 05:38:40.440;2017-12-02 10:55:10.743;317;34;100;66
32;32;2017-12-04 13:03:39.170;2017-12-04 14:47:00.787;104;34;89;55
32;32;2017-12-12 00:54:33.230;2017-12-12 03:18:31.470;144;34;89;55
32;32;2017-12-14 05:45:43.390;2017-12-14 08:20:23.550;155;42;89;47
32;32;2018-02-06 10:54:08.450;2018-02-06 12:44:03.007;110;33;89;56
32;32;2018-02-06 10:56:27.607;2018-02-06 12:44:03.007;108;33;89;56
32;32;2018-02-08 19:15:11.507;2018-02-08 21:13:07.243;118;33;89;56
36;36;2018-08-23 20:05:13.030;2018-08-23 21:28:23.723;83;34;89;55
36;36;2018-08-24 14:47:09.227;2018-08-24 21:26:45.147;399;33;34;1
36;36;2018-08-24 14:52:26.453;2018-08-24 21:26:45.147;394;33;34;1
32;32;2018-02-09 15:24:16.900;2018-02-09 16:56:41.600;92;34;89;55
32;32;2018-02-13 17:10:00.007;2018-02-13 18:25:04.583;75;34;89;55
32;32;2018-03-01 11:22:06.587;2018-03-01 12:44:53.233;82;34;89;55
36;36;2018-08-03 15:34:16.943;2018-08-03 17:30:30.420;116;33;89;56
36;36;2018-08-16 06:55:39.380;2018-08-16 08:26:45.027;91;34;89;55
36;36;2018-08-20 12:11:41.020;2018-08-20 14:23:37.757;132;33;89;56
36;36;2018-08-21 06:51:35.617;2018-08-21 09:42:55.607;171;34;89;55
36;36;2018-08-23 07:35:59.927;2018-08-23 08:59:03.380;84;33;89;56
36;36;2018-08-02 20:28:07.517;2018-08-02 22:36:36.313;128;34;89;55
36;36;2018-08-01 17:07:51.733;2018-08-01 18:50:08.387;103;33;89;56
36;36;2018-08-01 17:11:00.950;2018-08-01 18:50:08.387;99;33;89;56
36;36;2018-08-01 17:14:16.730;2018-08-01 18:50:08.387;96;33;89;56
36;36;2018-07-17 18:36:14.610;2018-07-18 08:03:44.963;807;33;89;56
36;36;2018-07-19 06:32:43.180;2018-07-19 07:28:03.423;56;33;71;38
36;36;2018-06-27 13:32:48.137;2018-06-27 15:10:31.773;98;34;89;55
36;36;2018-06-27 13:44:01.580;2018-06-27 15:10:31.773;86;34;89;55
32;32;2017-10-02 08:27:37.400;2017-10-02 09:29:16.850;62;28;80;52
32;32;2017-10-06 07:25:19.140;2017-10-06 08:35:18.973;70;34;89;55
32;32;2017-10-09 22:38:25.877;2017-10-09 23:35:20.467;57;33;89;56
32;32;2017-10-11 15:39:41.020;2017-10-11 16:37:14.273;58;34;89;55
32;32;2017-10-10 11:20:47.807;2017-10-10 12:17:19.483;57;34;89;55
32;32;2017-10-13 08:45:37.317;2017-10-13 11:20:59.810;155;34;89;55
32;32;2017-10-13 10:19:32.300;2017-10-13 11:20:59.810;61;34;89;55
36;36;2018-06-20 21:17:10.483;2018-06-20 22:49:28.220;92;34;89;55
32;32;2017-10-16 22:21:10.980;2017-10-16 23:22:24.037;61;34;89;55
32;32;2017-10-17 17:52:15.040;2017-10-17 19:03:46.500;71;34;89;55
32;32;2017-10-20 03:39:05.440;2017-10-20 04:53:47.550;74;28;89;61
32;32;2017-10-24 07:58:13.720;2017-10-24 23:00:44.670;902;88;89;1
32;32;2017-10-24 21:48:15.223;2017-10-24 23:00:44.670;72;33;89;56
32;32;2017-10-25 16:20:26.677;2017-10-25 17:39:06.257;79;33;89;56
32;32;2017-10-26 13:42:02.060;2017-10-26 15:05:06.477;83;34;89;55
32;32;2017-10-27 07:00:55.193;2017-10-27 08:13:11.640;73;33;89;56
36;36;2018-08-09 04:16:41.730;2018-08-09 05:43:56.677;87;34;89;55
36;36;2018-08-15 22:05:25.157;2018-08-15 22:27:51.297;22;33;39;6
36;36;2018-07-26 11:55:46.383;2018-07-26 13:40:57.430;105;33;89;56
36;36;2018-07-26 12:11:01.773;2018-07-26 13:40:57.430;89;33;89;56
36;36;2018-07-26 12:13:21.693;2018-07-26 13:40:57.430;87;33;89;56
36;36;2018-07-25 06:39:16.737;2018-07-25 08:25:52.907;106;33;76;43
36;36;2018-07-24 08:18:17.493;2018-07-24 09:27:12.457;69;31;72;41
36;36;2018-09-06 02:01:44.400;2018-09-06 03:37:05.700;96;32;89;57
36;36;2018-07-06 05:04:22.557;2018-07-06 06:30:15.543;86;33;89;56
36;36;2018-07-05 04:50:37.980;2018-07-05 08:57:23.857;247;34;92;58
36;36;2018-06-18 02:05:58.363;2018-06-18 21:43:24.577;1178;15;100;85
36;36;2018-06-07 08:43:53.650;2018-06-07 14:01:12.213;318;34;89;55
36;36;2018-06-07 12:06:43.160;2018-06-07 14:01:12.213;115;34;89;55
36;36;2018-06-11 21:20:43.553;2018-06-11 22:46:45.610;86;34;89;55
36;36;2018-06-15 12:38:22.643;2018-06-15 14:16:03.120;98;33;89;56
36;36;2018-06-15 12:51:42.527;2018-06-15 14:16:03.120;85;33;89;56
36;36;2018-05-22 20:13:24.113;2018-05-22 22:01:01.723;108;34;89;55
36;36;2018-05-21 01:16:24.143;2018-05-21 02:50:07.263;94;32;89;57
36;36;2018-04-25 17:34:16.297;2018-04-25 19:03:20.020;89;34;89;55
36;36;2018-05-15 13:45:52.573;2018-05-15 15:37:21.997;112;34;89;55
36;36;2018-04-30 06:41:43.247;2018-04-30 09:12:30.403;151;33;89;56
36;36;2018-04-27 12:48:11.260;2018-04-27 14:41:59.783;113;34;89;55
36;36;2018-04-26 16:20:45.433;2018-04-26 18:07:20.440;107;33;89;56
36;36;2018-04-26 11:17:44.550;2018-04-26 18:07:20.440;410;34;89;55
36;36;2018-04-26 11:18:53.643;2018-04-26 18:07:20.440;409;34;89;55
36;36;2018-04-20 04:09:22.527;2018-04-20 05:32:00.643;83;33;89;56
36;36;2018-04-18 07:46:55.667;2018-04-18 09:02:30.007;76;34;78;44
36;36;2018-04-17 12:01:34.880;2018-04-17 12:55:57.213;54;30;60;30
36;36;2018-03-26 20:44:34.620;2018-03-26 22:20:15.773;96;34;89;55
36;36;2018-03-22 07:46:03.200;2018-03-22 09:07:30.310;81;34;89;55
36;36;2018-06-05 04:07:00.727;2018-06-05 05:35:16.563;88;33;89;56
36;36;2018-05-29 13:29:34.620;2018-05-29 15:03:14.267;94;34;89;55
36;36;2018-05-14 15:25:29.520;2018-05-14 17:05:20.740;100;33;89;56
36;36;2018-05-10 12:31:03.417;2018-05-10 21:00:31.390;509;34;48;14
36;36;2018-05-10 12:32:21.970;2018-05-10 21:00:31.390;508;34;48;14
36;36;2018-05-04 01:46:43.697;2018-05-04 03:18:55.737;92;33;89;56
36;36;2018-04-09 02:54:04.650;2018-04-09 06:51:39.490;237;33;91;58
36;36;2018-04-04 15:03:55.300;2018-04-04 16:45:49.417;102;33;89;56
36;36;2018-02-05 07:50:24.627;2018-02-05 12:50:38.270;300;34;100;66
36;36;2018-02-16 15:52:08.840;2018-02-16 18:21:25.350;149;33;89;56
36;36;2018-01-23 20:58:08.307;2018-01-23 22:54:10.237;116;34;80;46
36;36;2018-01-24 16:34:33.993;2018-01-24 18:51:42.550;137;33;89;56
36;36;2018-01-24 16:41:16.280;2018-01-24 18:51:42.550;130;33;89;56
36;36;2018-01-19 09:54:46.980;2018-01-19 11:53:28.250;119;33;89;56
36;36;2018-01-16 05:24:26.370;2018-01-16 07:28:04.840;124;32;89;57
36;36;2018-01-08 22:41:34.077;2018-01-09 01:26:36.173;165;31;89;58
36;36;2018-01-08 23:06:05.703;2018-01-09 01:26:36.173;140;31;89;58
36;36;2018-01-08 23:15:27.430;2018-01-09 01:26:36.173;131;31;89;58
43;43;2018-01-11 09:26:56.137;2018-01-11 11:33:55.567;127;34;89;55
43;43;2018-01-19 09:46:15.143;2018-01-19 12:32:34.137;166;34;89;55
43;43;2018-01-23 19:23:16.510;2018-01-23 21:11:23.083;108;34;89;55
37;37;2018-09-24 15:54:57.887;2018-09-24 17:20:35.953;86;33;89;56
43;43;2018-01-28 23:09:28.010;2018-01-29 02:44:18.090;215;37;96;59
43;43;2018-01-25 16:14:20.450;2018-01-25 18:05:25.297;111;33;89;56
37;37;2018-09-25 09:30:19.673;2018-09-25 10:06:13.440;36;34;44;10
37;37;2018-09-25 10:08:54.210;2018-09-25 11:18:21.077;70;44;89;45
37;37;2018-09-21 00:54:28.183;2018-09-21 02:26:31.633;92;31;89;58
43;43;2017-10-18 06:20:30.003;2017-10-18 07:31:12.790;71;34;89;55
43;43;2017-10-19 18:23:23.953;2017-10-19 19:37:44.710;74;34;89;55
43;43;2017-10-24 03:24:43.607;2017-10-24 04:38:09.077;74;34;89;55
43;43;2017-10-24 03:34:12.503;2017-10-24 04:38:09.077;64;34;89;55
43;43;2017-10-24 15:58:42.703;2017-10-24 17:06:35.637;68;34;89;55
43;43;2017-10-31 01:34:29.600;2017-10-31 02:41:25.040;67;34;89;55
43;43;2017-11-02 07:02:43.607;2017-11-02 08:15:09.100;73;34;89;55
43;43;2017-11-06 12:20:01.130;2017-11-06 13:35:59.470;75;33;89;56
43;43;2017-11-10 03:59:37.613;2017-11-10 05:28:22.283;89;33;89;56
43;43;2017-11-14 14:10:03.990;2017-11-15 10:27:09.747;1217;33;73;40
43;43;2017-11-15 09:35:16.910;2017-11-15 10:27:09.747;52;33;73;40
43;43;2017-11-17 09:48:59.997;2017-11-17 10:59:26.610;71;33;89;56
43;43;2017-11-21 20:15:35.667;2017-11-21 21:35:40.180;80;33;89;56
43;43;2017-11-25 08:01:36.780;2017-11-25 13:10:54.913;309;42;100;58
43;43;2017-11-30 03:17:39.417;2017-11-30 05:07:43.903;110;33;89;56
43;43;2017-11-30 18:05:11.320;2017-11-30 19:55:51.867;110;34;89;55
43;43;2017-12-04 08:52:09.293;2017-12-04 12:44:05.610;232;34;95;61
43;43;2017-12-04 12:49:45.127;2017-12-07 10:21:06.730;4172;95;100;5
43;43;2017-12-11 15:13:51.910;2017-12-11 16:59:16.230;106;33;89;56
36;36;2018-01-17 16:06:58.340;2018-01-17 18:07:32.787;121;34;89;55
36;36;2018-01-17 16:15:38.493;2018-01-17 18:07:32.787;112;34;89;55
36;36;2018-01-16 05:36:39.253;2018-01-16 07:28:04.840;112;32;89;57
36;36;2018-01-16 23:44:42.717;2018-01-17 01:50:35.567;126;32;89;57
36;36;2018-01-16 23:56:45.790;2018-01-17 01:50:35.567;114;32;89;57
36;36;2018-01-12 02:34:07.273;2018-01-12 04:32:52.027;118;33;89;56
43;43;2018-01-09 14:38:53.807;2018-01-09 16:40:25.343;122;34;89;55
43;43;2018-01-10 09:09:27.167;2018-01-10 11:11:25.937;122;34;89;55
43;43;2018-01-12 07:52:30.377;2018-01-12 10:05:03.207;133;34;89;55
43;43;2018-01-16 08:35:34.670;2018-01-16 11:05:31.353;150;33;89;56
43;43;2018-01-24 21:06:19.097;2018-01-24 22:52:34.360;106;34;89;55
43;43;2018-01-28 21:59:00.993;2018-01-28 23:09:19.027;70;15;37;22
43;43;2018-01-28 23:17:11.303;2018-01-29 02:44:18.090;207;35;96;61
37;37;2018-09-21 00:39:38.750;2018-09-21 02:26:31.633;107;31;89;58
43;43;2018-01-25 16:03:29.590;2018-01-25 18:05:25.297;122;33;89;56
43;43;2017-10-17 12:53:46.787;2017-10-17 14:04:10.970;71;34;89;55
43;43;2017-10-18 21:56:41.543;2017-10-18 23:09:09.573;73;34;89;55
43;43;2017-11-02 21:17:48.213;2017-11-02 22:29:36.507;72;34;89;55
43;43;2017-11-07 08:08:23.063;2017-11-07 09:25:45.420;77;34;89;55
43;43;2017-11-08 06:31:28.470;2017-11-08 07:05:43.193;34;33;59;26
43;43;2017-11-08 07:06:09.033;2017-11-08 07:14:03.110;8;59;66;7
43;43;2017-11-08 18:08:41.693;2017-11-08 19:28:15.540;80;34;89;55
43;43;2017-11-14 14:09:13.870;2017-11-15 10:27:09.747;1218;33;73;40
43;43;2017-11-14 14:14:34.627;2017-11-15 10:27:09.747;1213;33;73;40
43;43;2017-11-15 10:31:30.703;2017-11-15 21:39:06.337;668;73;89;16
43;43;2017-11-15 20:28:32.573;2017-11-15 21:39:06.337;71;33;89;56
43;43;2017-11-23 13:19:23.503;2017-11-23 14:19:52.260;60;34;89;55
43;43;2017-11-24 08:47:25.110;2017-11-24 09:49:26.813;62;34;89;55
43;43;2017-11-27 12:49:33.963;2017-11-27 14:33:46.480;104;34;89;55
43;43;2017-11-29 09:59:13.920;2017-11-29 11:46:57.603;107;34;89;55
43;43;2017-12-01 09:57:51.067;2017-12-01 11:49:02.820;112;34;89;55
43;43;2017-12-09 08:00:55.580;2017-12-09 11:36:32.757;216;61;100;39
43;43;2017-12-12 11:13:32.350;2017-12-12 12:59:31.353;106;34;89;55
43;43;2017-12-14 16:54:03.197;2017-12-14 18:40:26.263;106;34;89;55
43;43;2017-12-21 12:26:49.153;2017-12-21 14:16:00.007;110;34;89;55
43;43;2017-12-22 07:21:16.187;2017-12-22 09:12:11.420;111;34;89;55
43;43;2017-12-26 08:06:18.173;2017-12-26 09:22:50.197;76;33;68;35
43;43;2017-12-27 13:26:04.053;2017-12-27 15:17:57.247;111;33;89;56
43;43;2017-12-28 05:07:17.470;2017-12-28 06:46:34.970;99;34;89;55
43;43;2018-01-31 00:33:50.713;2018-01-31 02:31:35.023;118;33;89;56
43;43;2018-02-01 17:40:27.060;2018-02-01 19:32:24.653;112;33;89;56
43;43;2018-02-15 19:28:12.047;2018-02-15 20:55:22.660;87;33;89;56
43;43;2018-02-16 13:12:33.250;2018-02-16 14:37:50.260;85;34;89;55
43;43;2018-02-21 03:06:33.337;2018-02-21 04:31:37.500;85;34;89;55
43;43;2018-02-21 03:10:45.877;2018-02-21 04:31:37.500;81;34;89;55
43;43;2018-02-20 06:45:56.227;2018-02-20 07:59:21.120;74;34;89;55
43;43;2018-02-06 06:31:26.050;2018-02-06 10:06:49.793;215;34;95;61
43;43;2018-02-06 06:38:16.550;2018-02-06 10:06:49.793;208;34;95;61
37;37;2018-09-19 14:56:11.437;2018-09-19 16:20:32.590;84;34;89;55
37;37;2018-09-17 11:41:14.460;2018-09-17 12:46:43.137;65;33;80;47
43;43;2018-02-09 05:42:55.093;2018-02-09 07:28:42.347;106;33;89;56
43;43;2018-02-13 04:49:07.630;2018-02-13 06:14:37.370;85;34;89;55
37;37;2018-09-10 14:02:45.167;2018-09-10 15:26:17.043;84;34;89;55
37;37;2018-09-12 06:29:14.270;2018-09-12 07:46:43.723;77;32;81;49
43;43;2018-03-05 06:22:31.387;2018-03-05 07:44:20.680;82;34;89;55
37;37;2018-09-09 00:01:10.640;2018-09-09 05:50:50.163;349;44;100;56
43;43;2018-03-02 15:25:42.883;2018-03-02 16:46:43.607;81;33;89;56
43;43;2018-03-01 00:44:08.217;2018-03-01 02:25:11.073;101;33;89;56
43;43;2018-04-02 23:34:38.163;2018-04-03 01:31:23.970;117;34;89;55
37;37;2018-08-02 23:36:12.230;2018-08-03 00:58:16.673;82;33;89;56
37;37;2018-08-24 09:49:21.977;2018-08-24 11:16:43.720;87;31;89;58
43;43;2018-05-03 05:35:16.127;2018-05-03 07:31:31.610;116;34;89;55
37;37;2018-08-21 12:58:18.807;2018-08-21 14:39:56.570;101;33;89;56
37;37;2018-08-21 13:06:42.043;2018-08-21 14:39:56.570;93;33;89;56
37;37;2018-08-21 13:15:10.127;2018-08-21 14:39:56.570;84;33;89;56
37;37;2018-08-20 19:32:52.800;2018-08-20 20:55:24.130;83;34;89;55
37;37;2018-08-20 05:54:24.810;2018-08-20 07:26:01.640;92;26;89;63
37;37;2018-08-17 08:39:56.657;2018-08-17 10:03:37.043;84;34;89;55
43;43;2018-05-11 06:41:33.160;2018-05-11 07:33:21.367;52;54;89;35
37;37;2018-08-16 10:12:32.677;2018-08-16 11:34:38.577;82;33;77;44
37;37;2018-08-16 10:13:12.867;2018-08-16 11:34:38.577;81;33;77;44
43;43;2018-05-09 19:37:50.277;2018-05-09 21:10:48.807;93;33;89;56
43;43;2018-05-12 05:34:43.943;2018-05-12 07:08:08.490;94;33;89;56
43;43;2018-05-14 21:26:51.423;2018-05-14 22:42:25.873;76;40;89;49
43;43;2018-05-25 20:17:32.900;2018-05-25 21:36:19.663;79;33;89;56
37;37;2018-08-01 13:29:02.543;2018-08-01 14:49:35.690;80;33;89;56
37;37;2018-08-02 08:21:07.897;2018-08-02 09:39:18.220;78;34;89;55
43;43;2018-05-31 14:02:47.523;2018-05-31 15:15:53.430;73;34;89;55
43;43;2018-06-04 10:50:38.870;2018-06-04 12:04:15.587;74;34;89;55
37;37;2018-07-20 06:02:13.990;2018-07-20 07:37:06.997;95;31;89;58
43;43;2018-03-22 12:50:57.983;2018-03-22 14:22:06.710;92;33;89;56
43;43;2018-03-21 05:45:10.603;2018-03-21 07:13:01.390;88;34;89;55
43;43;2018-03-24 11:41:15.347;2018-03-24 13:13:17.687;92;37;89;52
43;43;2018-03-27 11:15:08.630;2018-03-27 12:54:26.087;99;34;89;55
37;37;2018-07-16 14:28:48.977;2018-07-16 16:35:58.160;127;34;89;55
43;43;2018-04-18 14:27:20.970;2018-04-18 15:55:11.050;88;33;89;56
43;43;2018-04-23 19:38:27.277;2018-04-23 21:54:09.030;136;10;89;79
43;43;2018-04-30 07:17:51.003;2018-04-30 09:14:21.410;117;34;89;55
43;43;2018-05-02 10:41:59.383;2018-05-02 12:42:16.837;121;34;89;55
43;43;2018-05-16 11:14:10.797;2018-05-16 12:52:04.450;98;34;89;55
37;37;2018-06-28 00:09:28.907;2018-06-28 01:34:58.950;85;34;89;55
37;37;2018-06-27 08:37:36.660;2018-06-27 10:08:00.403;91;33;89;56
37;37;2018-06-25 19:29:35.600;2018-06-25 20:51:09.300;82;34;89;55
37;37;2018-06-22 13:32:19.560;2018-06-22 14:52:01.097;80;33;89;56
43;43;2018-06-16 01:40:45.600;2018-06-16 02:53:37.750;73;34;89;55
37;37;2018-06-21 17:35:51.457;2018-06-21 18:59:16.870;84;33;89;56
43;43;2018-06-12 13:24:08.617;2018-06-12 14:46:47.483;82;33;89;56
37;37;2018-06-19 12:10:44.330;2018-06-19 13:27:41.140;77;34;89;55
43;43;2018-06-07 07:07:23.787;2018-06-07 08:31:46.770;84;33;89;56
43;43;2018-06-07 07:12:04.147;2018-06-07 08:31:46.770;79;33;89;56
37;37;2018-06-05 15:31:02.490;2018-06-05 17:23:37.543;112;34;89;55
37;37;2018-06-05 15:42:07.070;2018-06-05 17:23:37.543;101;34;89;55
37;37;2018-06-02 01:55:55.067;2018-06-02 03:34:54.717;99;31;89;58
37;37;2018-06-01 07:50:54.020;2018-06-01 09:22:01.653;92;34;89;55
37;37;2018-05-30 07:20:30.293;2018-05-30 08:48:36.707;88;33;89;56
37;37;2018-05-27 03:43:16.867;2018-05-28 13:07:22.363;2004;71;100;29
37;37;2018-05-28 07:19:05.657;2018-05-28 13:07:22.363;348;33;100;67
43;43;2018-07-23 08:11:19.927;2018-07-23 09:28:26.710;77;34;82;48
43;43;2018-07-25 07:58:13.313;2018-07-25 09:58:12.967;120;34;89;55
43;43;2018-07-26 17:16:59.530;2018-07-26 18:55:54.703;99;34;89;55
43;43;2018-08-11 03:52:42.080;2018-08-11 05:18:31.070;86;31;89;58
43;43;2018-08-09 09:23:51.350;2018-08-09 10:41:55.580;78;33;89;56
43;43;2018-08-08 13:16:22.620;2018-08-08 14:37:24.287;81;33;89;56
37;37;2018-05-10 16:46:09.170;2018-05-10 18:12:56.913;86;34;89;55
37;37;2018-05-08 10:04:45.750;2018-05-08 11:27:48.393;83;33;89;56
37;37;2018-05-09 09:39:20.857;2018-05-09 10:23:10.393;44;33;62;29
37;37;2018-05-09 10:26:11.230;2018-05-09 11:07:23.477;41;62;89;27
37;37;2018-08-08 10:14:47.243;2018-08-08 11:39:19.277;85;33;89;56
43;43;2018-07-17 13:17:53.080;2018-07-17 14:38:58.900;81;33;89;56
43;43;2018-07-31 23:39:02.823;2018-08-01 01:25:24.637;106;34;89;55
37;37;2018-07-30 18:49:57.480;2018-07-30 18:56:49.350;7;85;89;4
37;37;2018-07-30 13:46:11.897;2018-07-30 15:02:59.457;76;34;89;55
43;43;2018-08-22 11:25:34.180;2018-08-22 12:42:36.317;77;33;89;56
43;43;2018-08-23 04:29:41.220;2018-08-23 05:48:58.533;79;31;89;58
43;43;2018-08-20 20:52:10.407;2018-08-20 22:21:19.580;89;34;89;55
43;43;2018-08-20 05:55:39.533;2018-08-20 07:26:09.427;91;32;89;57
43;43;2018-08-17 05:27:38.310;2018-08-17 07:18:48.180;111;32;89;57
43;43;2017-10-26 12:16:30.170;2017-10-26 13:25:56.547;69;34;89;55
43;43;2017-10-27 09:48:32.703;2017-10-27 10:59:17.680;71;34;89;55
43;43;2017-10-28 15:02:26.747;2017-10-28 19:19:21.467;257;45;100;55
43;43;2017-10-30 10:50:27.260;2017-10-30 11:55:19.340;65;33;89;56
43;43;2017-10-31 15:22:47.013;2017-10-31 15:58:44.807;36;34;62;28
43;43;2017-11-03 21:41:48.113;2017-11-03 22:58:24.317;77;33;89;56
43;43;2017-11-08 07:14:33.773;2017-11-08 07:37:30.310;23;66;84;18
43;43;2017-11-14 14:12:29.877;2017-11-15 10:27:09.747;1215;33;73;40
43;43;2017-11-20 10:43:33.160;2017-11-20 12:00:42.863;77;33;89;56
43;43;2017-11-21 02:59:49.727;2017-11-21 04:17:26.533;78;34;89;55
43;43;2017-11-22 15:40:04.090;2017-11-22 16:45:32.357;65;34;85;51
43;43;2017-11-22 16:45:38.250;2017-11-22 17:01:45.753;16;85;89;4
43;43;2017-11-28 03:43:10.547;2017-11-28 05:32:10.810;109;33;89;56
43;43;2017-11-28 17:04:25.953;2017-11-28 18:51:28.790;107;34;89;55
43;43;2017-12-02 09:24:37.860;2017-12-04 12:44:05.610;3080;49;95;46
43;43;2017-12-07 05:13:22.167;2017-12-07 10:21:06.730;308;33;100;67
43;43;2017-12-12 11:10:54.917;2017-12-12 12:59:31.353;109;34;89;55
43;43;2017-12-17 22:29:01.873;2017-12-18 03:44:35.510;315;31;100;69
43;43;2017-12-18 18:34:49.407;2017-12-18 20:23:58.240;109;34;89;55
43;43;2017-12-20 06:53:41.087;2017-12-20 08:42:53.820;109;34;89;55
43;43;2017-12-20 06:54:37.920;2017-12-20 08:42:53.820;108;34;89;55
43;43;2017-12-20 21:52:19.037;2017-12-20 23:42:20.060;110;34;89;55
43;43;2017-12-26 19:15:24.270;2017-12-26 21:07:30.200;112;34;89;55
43;43;2017-12-27 13:36:01.803;2017-12-27 15:17:57.247;101;33;89;56
43;43;2018-01-03 22:49:54.620;2018-01-04 00:53:18.377;124;33;89;56
43;43;2018-02-05 03:52:26.960;2018-02-05 07:49:19.017;237;33;96;63
43;43;2018-02-05 03:53:28.923;2018-02-05 07:49:19.017;236;33;96;63
43;43;2018-02-02 17:17:00.890;2018-02-02 19:07:18.583;110;33;89;56
43;43;2018-02-21 03:07:31.093;2018-02-21 04:31:37.500;84;34;89;55
37;37;2018-09-29 03:59:03.783;2018-09-29 05:17:50.167;78;33;89;56
43;43;2018-02-21 18:45:40.753;2018-02-21 19:59:56.880;74;34;89;55
43;43;2018-02-19 11:16:40.193;2018-02-19 12:43:29.007;87;34;89;55
43;43;2018-02-20 06:43:12.847;2018-02-20 07:59:21.120;76;34;89;55
37;37;2018-09-20 09:25:19.107;2018-09-20 10:49:24.857;84;33;89;56
43;43;2018-02-06 06:16:01.343;2018-02-06 10:06:49.793;230;34;95;61
43;43;2018-02-06 06:26:26.743;2018-02-06 10:06:49.793;220;34;95;61
43;43;2018-02-23 21:41:53.040;2018-02-23 23:02:02.800;81;31;89;58
37;37;2018-09-18 20:42:35.567;2018-09-18 22:04:35.113;82;33;89;56
37;37;2018-09-18 09:57:56.500;2018-09-18 10:20:48.903;23;58;73;15
43;43;2018-02-09 05:41:17.120;2018-02-09 07:28:42.347;107;33;89;56
37;37;2018-09-11 06:35:24.423;2018-09-11 08:03:17.800;88;34;89;55
43;43;2018-02-11 22:29:49.220;2018-02-12 03:26:35.200;297;22;100;78
37;37;2018-09-10 13:55:33.753;2018-09-10 15:26:17.043;91;34;89;55
43;43;2018-03-08 23:11:25.680;2018-03-09 00:45:31.413;94;31;89;58
43;43;2018-03-06 16:17:14.583;2018-03-06 17:37:11.957;80;33;89;56
43;43;2018-03-01 01:01:58.920;2018-03-01 02:25:11.073;84;33;89;56
43;43;2018-03-01 01:03:36.887;2018-03-01 02:25:11.073;82;33;89;56
43;43;2018-02-27 20:35:43.583;2018-02-27 21:51:56.693;76;33;89;56
43;43;2018-03-12 12:21:00.980;2018-03-12 13:40:24.320;79;34;89;55
43;43;2018-04-10 06:57:06.450;2018-04-10 09:31:39.337;154;34;89;55
43;43;2018-04-17 00:08:08.750;2018-04-17 01:17:05.253;69;34;82;48
43;43;2018-04-13 19:38:26.757;2018-04-13 21:41:37.340;123;33;89;56
43;43;2018-04-12 14:31:34.367;2018-04-12 15:52:33.750;81;33;89;56
37;37;2018-08-06 21:08:30.350;2018-08-06 22:31:38.717;83;33;89;56
43;43;2018-05-09 05:32:38.317;2018-05-09 06:54:34.487;82;33;89;56
37;37;2018-08-16 11:34:45.503;2018-08-16 12:00:21.053;26;77;89;12
43;43;2018-05-28 13:05:02.907;2018-05-28 14:22:44.250;77;34;89;55
43;43;2018-05-29 20:49:57.550;2018-05-29 22:10:01.487;81;34;89;55
43;43;2018-05-30 13:54:20.767;2018-05-30 15:16:32.223;82;34;89;55
43;43;2018-06-01 08:02:46.433;2018-06-01 09:18:20.973;76;33;89;56
43;43;2018-06-01 23:00:22.883;2018-06-04 12:04:15.587;3664;33;89;56
43;43;2018-02-27 07:49:46.140;2018-02-27 09:09:12.127;80;33;89;56
43;43;2018-02-27 07:53:35.470;2018-02-27 09:09:12.127;76;33;89;56
43;43;2018-03-20 08:03:14.127;2018-03-20 09:31:33.093;88;34;89;55
43;43;2018-03-15 17:40:50.020;2018-03-15 19:31:59.337;111;33;89;56
43;43;2018-03-14 22:42:35.860;2018-03-15 00:09:27.410;87;32;89;57
43;43;2018-03-23 09:03:23.850;2018-03-23 10:36:03.107;93;34;89;55
37;37;2018-07-17 10:10:10.943;2018-07-17 12:14:02.570;124;34;89;55
37;37;2018-07-13 20:14:32.413;2018-07-13 22:08:32.227;114;34;89;55
43;43;2018-04-19 07:10:11.410;2018-04-19 08:36:50.980;86;34;89;55
43;43;2018-05-17 07:42:59.717;2018-05-17 09:22:35.790;100;34;89;55
37;37;2018-06-27 08:41:06.277;2018-06-27 10:08:00.403;87;33;89;56
37;37;2018-06-27 08:43:55.820;2018-06-27 10:08:00.403;85;33;89;56
37;37;2018-06-25 06:33:06.763;2018-06-25 08:03:02.287;90;33;89;56
43;43;2018-05-23 03:46:30.130;2018-05-23 05:07:08.700;81;33;89;56
43;43;2018-05-23 21:04:52.200;2018-05-24 09:06:39.393;722;33;89;56
43;43;2018-06-18 02:29:13.540;2018-06-18 09:30:09.550;421;39;99;60
43;43;2018-06-18 07:33:59.683;2018-06-18 09:30:09.550;117;34;99;65
37;37;2018-06-20 20:41:57.720;2018-06-20 22:00:31.743;79;33;89;56
43;43;2018-06-11 20:28:52.837;2018-06-11 21:49:07.367;81;34;89;55
43;43;2018-06-08 07:12:21.730;2018-06-08 08:32:35.303;80;31;89;58
37;37;2018-05-29 13:45:52.063;2018-05-29 15:09:52.867;84;34;89;55
43;43;2018-07-11 17:00:59.500;2018-07-11 18:14:11.753;74;34;89;55
37;37;2018-05-31 00:32:21.620;2018-05-31 18:12:37.667;1060;34;70;36
43;43;2018-07-23 07:27:14.157;2018-07-23 09:28:26.710;121;34;82;48
43;43;2018-07-23 07:57:53.880;2018-07-23 09:28:26.710;91;34;82;48
43;43;2018-07-24 14:10:49.513;2018-07-24 15:45:26.167;95;34;89;55
43;43;2018-07-27 12:32:21.563;2018-07-27 14:13:59.030;101;34;89;55
37;37;2018-05-26 10:05:59.740;2018-05-26 11:31:59.657;86;32;89;57
37;37;2018-05-14 11:53:01.247;2018-05-14 13:23:38.567;90;34;89;55
43;43;2018-08-07 12:12:04.733;2018-08-08 14:37:24.287;1585;34;89;55
43;43;2018-08-08 13:03:57.357;2018-08-08 14:37:24.287;94;33;89;56
43;43;2018-08-14 07:32:00.370;2018-08-14 08:51:43.907;79;34;89;55
43;43;2018-08-10 01:05:28.560;2018-08-10 02:23:57.480;78;34;89;55
37;37;2018-05-10 04:45:36.140;2018-05-10 06:10:35.530;85;34;89;55
43;43;2018-06-26 04:34:17.873;2018-06-26 06:01:43.323;87;33;89;56
37;37;2018-05-07 11:38:30.160;2018-05-07 13:00:11.043;82;34;89;55
43;43;2018-07-16 15:04:29.137;2018-07-16 16:24:49.497;80;34;89;55
43;43;2018-07-14 06:03:04.270;2018-07-14 07:23:00.940;80;33;89;56
43;43;2018-07-18 10:19:40.087;2018-07-18 11:42:36.150;83;34;89;55
43;43;2018-08-23 17:42:20.150;2018-08-23 19:01:10.390;79;34;89;55
43;43;2018-08-22 11:26:36.727;2018-08-22 12:42:36.317;76;33;89;56
37;37;2018-07-27 04:16:42.953;2018-07-27 05:38:48.467;82;31;89;58
43;43;2018-08-21 12:41:19.313;2018-08-21 14:21:10.320;100;34;91;57
43;43;2018-08-16 06:53:02.953;2018-08-16 08:20:13.520;87;33;89;56
37;37;2018-07-11 10:17:57.743;2018-07-11 11:48:23.827;91;33;89;56
43;43;2018-08-24 09:19:45.880;2018-08-24 10:37:24.773;78;33;89;56
43;43;2018-08-24 09:19:47.690;2018-08-24 10:37:24.773;78;33;89;56
43;43;2018-08-24 09:19:50.013;2018-08-24 10:37:24.773;78;33;89;56
43;43;2018-08-24 09:19:51.027;2018-08-24 10:37:24.773;78;33;89;56
43;43;2018-08-24 09:19:53.077;2018-08-24 10:37:24.773;78;33;89;56
43;43;2018-08-24 09:19:54.000;2018-08-24 10:37:24.773;78;33;89;56
43;43;2018-08-24 09:20:04.707;2018-08-24 10:37:24.773;77;33;89;56
43;43;2018-09-12 15:33:20.117;2018-09-13 08:54:18.990;1041;32;89;57
37;37;2018-07-08 22:02:00.997;2018-07-09 03:39:34.033;337;35;100;65
43;43;2018-09-07 15:35:52.140;2018-09-07 16:56:30.033;81;34;89;55
43;43;2018-09-14 15:52:04.553;2018-09-14 21:03:33.903;311;33;89;56
37;37;2018-07-05 17:41:06.693;2018-07-05 19:25:02.257;104;34;89;55
43;43;2018-09-22 02:08:13.430;2018-09-22 03:21:01.430;73;33;89;56
43;43;2018-09-22 20:39:08.257;2018-09-26 11:39:22.207;5220;57;95;38
43;43;2018-08-28 14:58:03.807;2018-08-28 16:14:19.617;76;33;89;56
43;43;2018-08-29 05:43:26.300;2018-08-29 06:59:58.430;76;34;89;55
37;37;2018-06-16 04:19:25.110;2018-06-16 06:11:45.143;112;33;89;56
43;43;2018-08-29 07:37:39.130;2018-08-29 21:30:39.190;833;88;89;1
43;43;2018-09-03 14:08:09.973;2018-09-03 15:23:41.170;75;33;88;55
43;43;2018-09-05 08:36:01.567;2018-09-05 09:55:32.860;79;34;89;55
37;37;2018-06-11 17:10:42.733;2018-06-11 17:49:32.957;39;63;89;26
43;43;2017-10-20 20:06:42.817;2017-10-20 21:25:37.760;79;33;89;56
43;43;2017-10-22 21:53:56.297;2017-10-23 02:19:00.530;266;43;97;54
43;43;2017-10-25 14:20:52.197;2017-10-25 15:30:26.420;70;33;89;56
43;43;2017-10-31 16:03:10.683;2017-10-31 16:36:50.910;33;62;89;27
43;43;2017-11-09 10:46:15.840;2017-11-09 12:09:20.123;83;33;89;56
43;43;2017-11-10 04:00:55.193;2017-11-10 05:28:22.283;88;33;89;56
43;43;2017-11-12 21:56:05.107;2017-11-13 02:19:06.557;263;41;100;59
43;43;2017-11-14 00:00:21.830;2017-11-14 01:05:16.040;65;33;89;56
43;43;2017-11-14 14:15:23.253;2017-11-15 10:27:09.747;1212;33;73;40
43;43;2017-11-15 10:27:15.087;2017-11-15 21:39:06.337;672;73;89;16
43;43;2017-11-16 14:59:34.700;2017-11-16 16:10:01.163;71;34;89;55
43;43;2017-12-08 03:44:12.037;2017-12-08 06:05:32.820;141;50;89;39
43;43;2017-12-08 04:55:30.267;2017-12-08 06:05:32.820;70;48;89;41
43;43;2017-12-12 11:12:09.717;2017-12-12 12:59:31.353;107;34;89;55
43;43;2017-12-15 09:25:55.043;2017-12-15 11:16:59.793;111;34;89;55
43;43;2017-12-17 22:23:43.610;2017-12-18 03:44:35.510;321;32;100;68
43;43;2017-12-17 22:27:00.100;2017-12-18 03:44:35.510;317;31;100;69
43;43;2017-12-18 18:31:51.083;2017-12-18 20:23:58.240;112;34;89;55
43;43;2017-12-19 12:16:21.220;2017-12-19 14:04:18.273;108;34;89;55
43;43;2017-12-26 09:24:37.057;2017-12-26 09:27:26.057;3;67;69;2
43;43;2017-12-28 19:12:27.057;2017-12-28 20:54:08.417;102;33;89;56
43;43;2017-12-30 07:09:27.653;2017-12-30 12:38:19.603;329;33;100;67
43;43;2018-01-03 08:26:37.420;2018-01-03 10:13:19.740;107;34;89;55
43;43;2018-01-03 22:56:19.917;2018-01-04 00:53:18.377;117;33;89;56
43;43;2018-01-03 23:01:55.507;2018-01-04 00:53:18.377;112;33;89;56
43;43;2018-01-31 00:40:04.000;2018-01-31 02:31:35.023;111;33;89;56
43;43;2018-02-21 03:08:08.923;2018-02-21 04:31:37.500;83;34;89;55
43;43;2018-02-21 18:43:42.080;2018-02-21 19:59:56.880;76;34;89;55
37;37;2018-09-29 03:59:51.267;2018-09-29 05:17:50.167;78;33;89;56
43;43;2018-02-26 12:32:36.067;2018-02-26 13:48:52.503;76;32;89;57
43;43;2018-02-06 06:17:54.107;2018-02-06 10:06:49.793;229;34;95;61
43;43;2018-02-07 08:10:32.903;2018-02-07 11:08:04.950;178;34;100;66
37;37;2018-09-13 16:48:23.903;2018-09-13 18:25:35.480;97;31;93;62
43;43;2018-02-13 18:19:40.967;2018-02-13 19:42:17.513;83;34;89;55
43;43;2018-03-08 06:39:00.533;2018-03-08 08:01:59.023;82;33;89;56
43;43;2018-03-08 06:40:29.360;2018-03-08 08:01:59.023;81;33;89;56
37;37;2018-09-07 17:01:02.263;2018-09-07 18:25:34.830;84;33;89;56
43;43;2018-03-05 06:24:09.497;2018-03-05 07:44:20.680;80;34;89;55
43;43;2018-03-01 00:29:30.543;2018-03-01 02:25:11.073;116;33;89;56
43;43;2018-03-01 00:56:48.790;2018-03-01 02:25:11.073;89;33;89;56
43;43;2018-02-27 20:33:35.690;2018-02-27 21:51:56.693;78;33;89;56
43;43;2018-03-13 09:50:41.390;2018-03-13 11:12:26.583;82;34;89;55
43;43;2018-04-04 11:58:32.433;2018-04-04 14:03:34.037;125;34;89;55
43;43;2018-04-05 09:45:42.063;2018-04-05 11:58:52.883;133;34;89;55
37;37;2018-09-07 01:28:15.003;2018-09-07 02:50:57.077;82;34;89;55
43;43;2018-04-06 11:47:31.260;2018-04-06 14:08:34.860;141;34;89;55
43;43;2018-05-05 07:43:26.043;2018-05-05 09:54:07.663;131;35;89;54
43;43;2018-05-04 08:18:39.943;2018-05-04 10:28:59.580;130;26;89;63
43;43;2018-04-13 20:18:51.300;2018-04-13 21:41:37.340;83;33;89;56
43;43;2018-05-08 13:08:05.847;2018-05-08 14:28:51.287;80;33;89;56
43;43;2018-05-11 06:05:21.247;2018-05-11 06:40:51.480;35;34;54;20
43;43;2018-05-10 12:25:29.990;2018-05-10 13:50:40.043;85;34;89;55
37;37;2018-08-07 11:39:51.530;2018-08-07 13:03:49.910;84;34;89;55
43;43;2018-05-09 19:47:22.630;2018-05-09 21:10:48.807;83;33;89;56
37;37;2018-08-16 06:45:35.677;2018-08-16 11:34:38.577;289;40;77;37
37;37;2018-08-16 10:16:15.263;2018-08-16 11:34:38.577;78;33;77;44
37;37;2018-08-06 07:53:39.757;2018-08-06 09:15:42.320;82;34;89;55
37;37;2018-08-03 14:45:32.360;2018-08-03 16:08:19.900;83;33;89;56
43;43;2018-06-05 05:30:53.567;2018-06-05 06:45:45.313;75;34;89;55
43;43;2018-03-21 20:31:47.947;2018-03-21 22:01:15.947;90;33;89;56
43;43;2018-03-16 09:35:12.360;2018-03-16 11:02:00.530;87;33;89;56
37;37;2018-07-19 06:43:02.270;2018-07-19 08:05:35.420;82;33;89;56
37;37;2018-07-18 11:56:29.967;2018-07-18 13:15:31.260;79;34;89;55
37;37;2018-07-16 14:36:37.257;2018-07-16 16:35:58.160;119;34;89;55
43;43;2018-03-26 15:09:00.363;2018-03-26 16:48:26.730;99;33;89;56
43;43;2018-04-02 07:10:12.177;2018-04-02 09:03:49.460;113;33;89;56
43;43;2018-04-02 07:11:45.170;2018-04-02 09:03:49.460;112;33;89;56
37;37;2018-07-13 20:23:11.630;2018-07-13 22:08:32.227;105;34;89;55
37;37;2018-07-13 00:20:40.173;2018-07-13 02:01:08.900;101;33;89;56
37;37;2018-07-12 07:22:08.780;2018-07-12 08:52:55.597;90;34;88;54
43;43;2018-05-15 15:02:07.400;2018-05-15 16:37:50.727;95;34;89;55
37;37;2018-06-27 08:43:14.837;2018-06-27 10:08:00.403;85;33;89;56
43;43;2018-05-22 04:14:29.200;2018-05-22 06:52:00.727;158;34;89;55
43;43;2018-05-22 04:57:52.983;2018-05-22 06:52:00.727;115;34;89;55
43;43;2018-05-18 03:58:06.777;2018-05-18 05:42:25.843;104;34;89;55
43;43;2018-05-24 23:48:05.097;2018-05-25 01:08:35.320;80;34;89;55
43;43;2018-06-06 13:08:00.290;2018-06-06 14:25:05.673;77;33;89;56
43;43;2018-06-07 06:50:06.677;2018-06-07 08:31:46.770;101;33;89;56
43;43;2018-06-07 07:11:01.300;2018-06-07 08:31:46.770;80;33;89;56
43;43;2018-07-23 07:59:06.100;2018-07-23 09:28:26.710;89;34;82;48
43;43;2018-07-23 08:07:20.840;2018-07-23 09:28:26.710;81;34;82;48
43;43;2018-07-23 08:08:23.690;2018-07-23 09:28:26.710;80;34;82;48
37;37;2018-05-31 17:08:19.683;2018-05-31 18:12:37.667;64;33;70;37
37;37;2018-05-27 00:02:15.150;2018-05-28 13:07:22.363;2225;75;100;25
43;43;2018-07-25 08:22:00.030;2018-07-25 09:58:12.967;96;34;89;55
37;37;2018-05-15 06:21:05.567;2018-05-15 07:52:58.713;91;33;89;56
43;43;2018-08-11 01:33:10.297;2018-08-11 05:18:31.070;225;32;89;57
37;37;2018-05-11 15:32:29.720;2018-05-11 17:00:44.150;88;33;89;56
43;43;2018-08-08 08:55:25.830;2018-08-08 14:37:24.287;342;33;89;56
43;43;2018-08-09 23:47:30.013;2018-08-10 02:23:57.480;156;34;89;55
43;43;2018-06-22 12:25:26.443;2018-06-22 13:44:21.993;79;34;89;55
43;43;2018-07-13 01:50:22.043;2018-07-13 03:13:16.710;83;33;89;56
43;43;2018-07-19 07:29:18.967;2018-07-19 08:56:53.110;87;34;89;55
37;37;2018-07-28 04:17:02.927;2018-07-28 05:40:19.950;83;31;89;58
37;37;2018-07-30 13:48:51.037;2018-07-30 15:02:59.457;74;34;89;55
43;43;2018-08-23 15:55:59.110;2018-08-23 19:01:10.390;186;34;89;55
43;43;2018-08-23 17:38:34.390;2018-08-23 19:01:10.390;83;34;89;55
43;43;2018-08-21 12:43:54.120;2018-08-21 14:21:10.320;98;34;91;57
43;43;2018-08-17 05:50:12.117;2018-08-17 07:18:48.180;88;32;89;57
43;43;2018-08-07 12:03:58.133;2018-08-07 12:11:47.180;8;33;34;1
37;37;2018-07-10 16:04:33.110;2018-07-10 17:32:32.527;88;34;89;55
43;43;2018-08-25 05:18:11.220;2018-08-25 06:39:39.957;81;33;89;56
43;43;2018-08-24 09:19:44.007;2018-08-24 10:37:24.773;78;33;89;56
43;43;2018-08-24 09:19:44.887;2018-08-24 10:37:24.773;78;33;89;56
43;43;2018-08-24 09:19:55.873;2018-08-24 10:37:24.773;78;33;89;56
43;43;2018-08-24 09:20:03.390;2018-08-24 10:37:24.773;77;33;89;56
37;37;2018-07-10 02:20:10.720;2018-07-10 03:46:00.160;86;33;89;56
43;43;2018-09-10 10:38:11.570;2018-09-10 11:58:45.130;80;33;89;56
43;43;2018-09-11 06:36:10.073;2018-09-11 07:48:25.323;72;34;89;55
43;43;2018-09-11 20:42:17.387;2018-09-11 22:40:39.920;118;33;89;56
43;43;2018-09-14 19:41:59.727;2018-09-14 21:03:33.903;82;33;89;56
37;37;2018-07-06 12:51:32.023;2018-07-06 14:39:24.187;108;34;89;55
37;37;2018-06-13 06:20:48.570;2018-06-13 07:52:25.620;92;33;89;56
37;37;2018-07-03 09:01:10.727;2018-07-03 10:51:11.383;110;34;89;55
37;37;2018-07-03 09:22:37.720;2018-07-03 10:51:11.383;89;34;89;55
43;43;2018-08-28 00:49:39.230;2018-08-28 02:12:02.427;83;33;89;56
43;43;2018-09-28 10:47:51.010;2018-09-28 12:25:33.423;98;33;95;62
37;37;2018-06-18 15:47:40.703;2018-06-18 17:23:26.740;96;34;92;58
43;43;2018-08-29 05:42:33.270;2018-08-29 06:59:58.430;77;34;89;55
37;37;2018-06-14 04:24:55.557;2018-06-14 06:05:06.187;101;32;89;57
43;43;2018-08-31 19:11:43.963;2018-08-31 20:30:27.460;79;34;89;55
43;43;2018-09-05 23:21:08.093;2018-09-06 00:43:40.277;82;33;89;56
37;37;2018-05-24 22:23:57.590;2018-05-25 01:33:23.113;190;33;89;56
37;37;2018-05-18 11:06:54.457;2018-05-18 12:53:19.870;107;34;89;55
37;37;2018-05-21 08:09:17.007;2018-05-21 10:04:59.903;115;34;89;55
37;37;2018-05-15 22:58:33.230;2018-05-16 00:39:07.920;101;32;89;57
37;37;2018-04-30 22:54:45.543;2018-05-01 00:12:08.643;78;34;89;55
43;43;2017-12-12 11:06:12.600;2017-12-12 12:59:31.353;113;34;89;55
43;43;2017-12-12 11:08:56.853;2017-12-12 12:59:31.353;111;34;89;55
43;43;2017-12-13 06:48:56.973;2017-12-13 08:32:41.573;104;34;89;55
43;43;2017-12-14 01:04:54.800;2017-12-14 02:53:32.493;109;33;89;56
43;43;2017-12-17 22:22:13.740;2017-12-18 03:44:35.510;322;33;100;67
43;43;2017-12-17 22:28:11.233;2017-12-18 03:44:35.510;316;31;100;69
43;43;2017-12-28 05:05:27.750;2017-12-28 06:46:34.970;101;34;89;55
43;43;2017-12-28 19:10:54.823;2017-12-28 20:54:08.417;104;33;89;56
43;43;2018-01-02 02:58:48.903;2018-01-02 04:30:28.010;92;41;89;48
43;43;2018-01-02 15:59:07.297;2018-01-02 17:46:59.547;107;33;89;56
43;43;2018-01-31 00:13:58.793;2018-01-31 02:31:35.023;138;33;89;56
43;43;2018-01-31 00:35:19.530;2018-01-31 02:31:35.023;116;33;89;56
43;43;2018-01-31 21:14:52.057;2018-01-31 23:03:35.147;109;34;89;55
43;43;2018-02-02 17:15:49.017;2018-02-02 19:07:18.583;112;33;89;56
43;43;2018-02-15 19:30:32.440;2018-02-15 20:55:22.660;85;33;89;56
43;43;2018-02-06 06:33:29.183;2018-02-06 10:06:49.793;213;34;95;61
43;43;2018-02-23 03:36:32.193;2018-02-23 04:53:14.510;77;33;89;56
43;43;2018-02-08 07:19:00.770;2018-02-08 09:03:16.507;104;34;89;55
37;37;2018-09-12 21:17:44.550;2018-09-12 22:53:25.040;96;34;89;55
43;43;2018-02-14 13:17:59.500;2018-02-14 14:40:45.233;83;34;89;55
43;43;2018-03-09 13:22:23.360;2018-03-09 14:43:51.580;81;34;89;55
43;43;2018-03-08 03:16:49.620;2018-03-08 08:01:59.023;285;33;89;56
43;43;2018-03-07 09:45:22.840;2018-03-07 11:03:08.113;78;34;89;55
43;43;2018-03-05 06:25:38.823;2018-03-05 07:44:20.680;79;34;89;55
43;43;2018-03-06 00:45:02.057;2018-03-06 02:02:22.313;77;34;89;55
43;43;2018-03-01 20:05:23.407;2018-03-01 21:23:50.533;78;33;89;56
43;43;2018-04-03 17:20:07.263;2018-04-03 19:18:50.543;118;33;89;56
43;43;2018-04-09 08:58:04.167;2018-04-09 11:30:01.030;152;34;89;55
43;43;2018-04-11 07:30:43.423;2018-04-11 08:48:58.560;78;33;89;56
37;37;2018-08-23 06:51:51.460;2018-08-23 08:16:34.403;85;34;89;55
43;43;2018-04-11 21:50:45.297;2018-04-11 23:10:59.347;80;34;89;55
37;37;2018-08-22 08:26:48.343;2018-08-22 09:51:21.113;85;34;89;55
43;43;2018-04-16 09:55:08.003;2018-04-16 11:16:42.773;81;34;89;55
43;43;2018-04-13 04:21:19.513;2018-04-13 05:43:20.000;82;33;89;56
43;43;2018-05-07 08:52:56.433;2018-05-07 14:29:02.710;337;34;100;66
43;43;2018-05-09 19:36:51.553;2018-05-09 21:10:48.807;94;33;89;56
43;43;2018-05-14 21:07:03.253;2018-05-14 21:26:09.867;19;34;40;6
43;43;2018-05-26 16:01:03.283;2018-05-26 21:13:04.730;312;60;100;40
37;37;2018-08-16 10:11:33.503;2018-08-16 11:34:38.577;83;33;77;44
43;43;2018-05-30 13:56:25.593;2018-05-30 15:16:32.223;80;34;89;55
37;37;2018-07-31 18:00:38.057;2018-07-31 19:19:16.053;79;33;89;56
43;43;2018-03-14 06:43:55.513;2018-03-14 08:11:35.407;88;34;89;55
43;43;2018-03-14 06:48:13.513;2018-03-14 08:11:35.407;83;34;89;55
43;43;2018-02-27 07:51:33.277;2018-02-27 09:09:12.127;78;33;89;56
43;43;2018-02-27 07:52:20.320;2018-02-27 09:09:12.127;77;33;89;56
37;37;2018-07-21 00:28:38.883;2018-07-21 01:54:08.433;86;32;89;57
43;43;2018-03-19 11:29:08.277;2018-03-19 13:04:55.407;95;34;89;55
43;43;2018-04-17 14:43:15.073;2018-04-17 16:06:40.517;83;34;89;55
43;43;2018-04-25 13:23:12.020;2018-04-25 15:09:04.647;106;34;89;55
43;43;2018-04-26 07:00:28.260;2018-04-26 08:40:59.883;100;34;89;55
43;43;2018-04-27 03:30:07.677;2018-04-27 05:14:48.873;104;32;89;57
43;43;2018-05-02 10:07:33.757;2018-05-02 12:42:16.837;155;34;89;55
37;37;2018-06-26 13:41:03.713;2018-06-26 15:04:05.387;83;33;89;56
43;43;2018-05-21 09:01:29.307;2018-05-21 10:57:18.713;116;32;89;57
37;37;2018-06-25 06:42:11.430;2018-06-25 08:03:02.287;81;33;89;56
43;43;2018-05-24 07:34:03.307;2018-05-24 09:06:39.393;92;28;89;61
43;43;2018-06-18 02:04:49.313;2018-06-18 09:30:09.550;446;39;99;60
43;43;2018-06-18 02:27:16.813;2018-06-18 09:30:09.550;423;39;99;60
43;43;2018-06-18 07:36:40.827;2018-06-18 09:30:09.550;114;34;99;65
43;43;2018-06-13 07:45:29.803;2018-06-13 09:10:10.530;85;33;89;56
43;43;2018-06-10 22:31:27.400;2018-06-11 03:45:00.080;314;44;100;56
37;37;2018-06-20 06:19:25.563;2018-06-20 07:37:02.160;78;34;89;55
37;37;2018-06-05 15:43:54.923;2018-06-05 17:23:37.543;100;34;89;55
43;43;2018-07-10 09:38:40.870;2018-07-10 11:09:00.877;91;34;89;55
43;43;2018-07-10 09:39:35.227;2018-07-10 11:09:00.877;90;34;89;55
37;37;2018-06-04 19:28:05.077;2018-06-04 21:06:45.827;98;34;89;55
43;43;2018-07-23 08:14:56.213;2018-07-23 09:28:26.710;74;34;82;48
37;37;2018-05-31 17:15:24.610;2018-05-31 18:12:37.667;57;33;70;37
43;43;2018-07-23 21:50:10.877;2018-07-23 23:17:05.170;87;33;89;56
43;43;2018-07-23 21:51:49.177;2018-07-23 23:17:05.170;86;33;89;56
43;43;2018-07-25 07:59:22.370;2018-07-25 09:58:12.967;119;34;89;55
43;43;2018-07-26 01:28:26.520;2018-07-26 03:05:22.953;97;34;89;55
43;43;2018-07-30 07:37:10.417;2018-07-30 09:19:23.310;102;34;89;55
43;43;2018-08-27 10:50:07.213;2018-08-27 12:04:06.090;74;34;89;55
43;43;2018-08-13 05:58:44.867;2018-08-13 09:01:04.797;183;34;100;66
37;37;2018-08-09 15:48:49.670;2018-08-09 17:13:46.513;85;34;89;55
43;43;2018-06-05 22:40:41.740;2018-06-06 00:02:23.257;82;31;89;58
43;43;2018-06-21 06:56:34.480;2018-06-21 12:13:43.240;317;33;100;67
43;43;2018-06-25 03:18:01.490;2018-06-25 04:38:49.800;80;34;89;55
43;43;2018-07-13 01:56:02.310;2018-07-13 03:13:16.710;77;33;89;56
43;43;2018-07-12 09:45:31.917;2018-07-12 10:59:19.353;74;33;89;56
37;37;2018-08-08 10:08:52.260;2018-08-08 11:39:19.277;91;33;89;56
43;43;2018-07-14 16:01:47.557;2018-07-14 20:33:50.487;272;79;100;21
43;43;2018-07-20 07:00:29.760;2018-07-20 08:29:00.493;89;33;89;56
43;43;2018-07-31 06:27:52.507;2018-07-31 08:13:59.043;106;33;89;56
43;43;2018-08-23 16:12:45.137;2018-08-23 19:01:10.390;169;34;89;55
37;37;2018-07-25 13:54:32.633;2018-07-25 15:10:16.990;76;34;89;55
37;37;2018-07-26 08:49:43.920;2018-07-26 10:03:54.147;74;34;89;55
43;43;2018-08-17 05:51:41.483;2018-08-17 07:18:48.180;87;32;89;57
43;43;2018-08-16 21:25:21.807;2018-08-17 07:18:48.180;593;34;89;55
37;37;2018-07-24 02:16:22.463;2018-07-24 03:48:24.007;92;33;89;56
37;37;2018-07-23 22:06:43.173;2018-07-24 03:48:24.007;342;33;89;56
43;43;2018-08-24 09:19:49.383;2018-08-24 10:37:24.773;78;33;89;56
43;43;2018-08-24 09:19:58.577;2018-08-24 10:37:24.773;78;33;89;56
43;43;2018-08-24 09:20:00.573;2018-08-24 10:37:24.773;77;33;89;56
43;43;2018-08-24 09:20:10.163;2018-08-24 10:37:24.773;77;33;89;56
43;43;2018-09-10 10:36:27.940;2018-09-10 11:58:45.130;82;33;89;56
43;43;2018-09-17 11:50:19.677;2018-09-17 13:02:25.447;72;34;89;55
43;43;2018-09-14 19:21:55.897;2018-09-14 21:03:33.903;102;33;89;56
43;43;2018-09-23 22:23:20.987;2018-09-26 11:39:22.207;3676;0;95;95
43;43;2018-09-26 09:37:08.470;2018-09-26 11:39:22.207;122;0;95;95
37;37;2018-07-04 23:01:43.480;2018-07-05 00:42:12.807;101;34;89;55
37;37;2018-07-03 09:24:37.853;2018-07-03 10:51:11.383;87;34;89;55
43;43;2018-08-28 00:48:50.193;2018-08-28 02:12:02.427;84;33;89;56
37;37;2018-07-02 14:58:01.413;2018-07-02 15:19:11.523;21;77;89;12
43;43;2018-08-29 05:41:49.410;2018-08-29 06:59:58.430;78;34;89;55
43;43;2018-08-31 04:43:58.470;2018-08-31 06:01:29.527;78;33;89;56
43;43;2018-09-04 11:12:10.933;2018-09-04 13:56:54.523;164;34;89;55
43;43;2018-09-04 12:37:03.900;2018-09-04 13:56:54.523;79;34;89;55
37;37;2018-06-12 09:56:11.400;2018-06-12 11:22:49.607;86;34;89;55
37;37;2018-06-11 16:13:34.967;2018-06-11 17:07:24.167;54;34;63;29
37;37;2018-06-11 17:11:35.363;2018-06-11 17:49:32.957;38;63;89;26
37;37;2018-06-06 18:36:49.783;2018-06-06 19:59:46.667;83;30;89;59
37;37;2018-05-24 23:13:09.413;2018-05-25 01:33:23.113;140;33;89;56
37;37;2018-05-17 15:38:48.850;2018-05-17 17:23:35.260;105;34;89;55
37;37;2018-05-17 16:32:48.697;2018-05-17 17:23:35.260;51;66;89;23
37;37;2018-05-02 08:41:21.177;2018-05-02 09:57:30.027;76;33;89;56
37;37;2018-05-03 11:19:58.003;2018-05-03 12:39:33.733;80;34;89;55
37;37;2018-05-03 11:20:31.050;2018-05-03 12:39:33.733;79;34;89;55
37;37;2018-04-13 01:40:07.663;2018-04-13 03:35:12.560;115;34;89;55
37;37;2018-04-06 16:53:12.377;2018-04-06 18:23:06.680;90;34;89;55
37;37;2018-04-04 13:33:54.863;2018-04-04 14:57:57.400;84;34;89;55
37;37;2018-03-09 07:30:29.300;2018-03-09 08:54:08.950;84;33;89;56
37;37;2018-03-06 07:23:54.283;2018-03-06 08:42:35.520;79;34;89;55
37;37;2018-03-08 14:59:31.590;2018-03-08 16:22:21.457;83;33;89;56
37;37;2018-02-28 15:39:44.877;2018-02-28 16:54:51.517;75;34;89;55
37;37;2018-03-01 11:21:41.830;2018-03-01 12:38:11.850;77;33;89;56
43;43;2018-08-17 05:49:14.610;2018-08-17 07:18:48.180;89;32;89;57
37;37;2018-07-24 18:09:20.270;2018-07-24 19:35:02.330;86;34;89;55
43;43;2018-08-06 20:44:57.913;2018-08-06 22:00:10.353;76;34;89;55
43;43;2018-08-06 08:27:01.577;2018-08-06 09:40:39.337;73;33;89;56
43;43;2018-08-03 04:59:10.293;2018-08-03 06:26:46.283;87;33;93;60
43;43;2018-08-01 18:04:30.067;2018-08-01 19:54:56.813;110;34;89;55
43;43;2018-08-24 09:19:42.670;2018-08-24 10:37:24.773;78;33;89;56
43;43;2018-08-24 09:19:46.740;2018-08-24 10:37:24.773;78;33;89;56
43;43;2018-08-24 09:19:48.490;2018-08-24 10:37:24.773;78;33;89;56
43;43;2018-08-24 09:19:51.680;2018-08-24 10:37:24.773;78;33;89;56
43;43;2018-08-24 09:19:57.530;2018-08-24 10:37:24.773;78;33;89;56
43;43;2018-09-06 13:42:27.010;2018-09-06 15:04:50.630;82;34;89;55
43;43;2018-09-12 15:31:50.247;2018-09-13 08:54:18.990;1043;32;89;57
43;43;2018-09-13 07:41:30.960;2018-09-13 08:54:18.990;73;33;89;56
43;43;2018-09-11 21:26:26.900;2018-09-11 22:40:39.920;74;33;89;56
43;43;2018-09-14 19:50:09.967;2018-09-14 21:03:33.903;73;33;89;56
43;43;2018-09-22 16:01:41.867;2018-09-26 11:39:22.207;5498;64;95;31
37;37;2018-07-04 06:26:24.617;2018-07-04 08:03:04.970;97;34;89;55
43;43;2018-08-28 14:24:39.880;2018-08-28 16:14:19.617;110;33;89;56
37;37;2018-06-14 22:34:36.900;2018-06-15 00:17:05.280;103;34;89;55
43;43;2018-08-29 07:46:17.420;2018-08-29 21:30:39.190;824;88;89;1
43;43;2018-08-29 20:13:40.810;2018-08-29 21:30:39.190;77;34;89;55
43;43;2018-08-30 12:24:48.120;2018-08-30 13:45:25.897;81;32;89;57
37;37;2018-06-10 00:02:06.530;2018-06-10 05:20:54.007;318;70;100;30
43;43;2018-09-04 10:20:09.247;2018-09-04 13:56:54.523;216;34;89;55
43;43;2018-09-04 11:14:02.493;2018-09-04 13:56:54.523;162;34;89;55
43;43;2018-09-04 11:27:46.277;2018-09-04 13:56:54.523;149;34;89;55
43;43;2018-09-03 15:27:37.343;2018-09-04 13:56:54.523;1349;88;89;1
37;37;2018-05-24 22:43:52.173;2018-05-25 01:33:23.113;170;33;89;56
37;37;2018-05-23 03:47:02.973;2018-05-23 05:49:27.823;122;33;89;56
37;37;2018-05-22 06:40:46.490;2018-05-22 08:39:42.457;119;30;89;59
37;37;2018-04-30 06:40:29.500;2018-04-30 08:21:04.260;101;34;89;55
37;37;2018-04-26 11:47:07.390;2018-04-26 12:54:55.127;67;34;78;44
37;37;2018-04-26 13:35:21.070;2018-04-26 14:06:02.937;31;76;89;13
37;37;2018-05-04 23:16:23.300;2018-05-05 00:36:55.053;80;34;89;55
37;37;2018-04-24 11:58:12.353;2018-04-24 13:22:13.763;84;34;89;55
37;37;2018-04-12 11:22:16.950;2018-04-12 12:28:10.987;66;33;75;42
37;37;2018-04-11 14:10:25.843;2018-04-11 16:01:48.090;111;34;89;55
37;37;2018-04-10 20:37:18.253;2018-04-10 22:23:34.840;106;34;89;55
37;37;2018-04-05 09:36:55.030;2018-04-05 11:03:29.840;87;33;89;56
37;37;2018-03-11 22:50:12.097;2018-03-12 00:17:36.383;87;30;89;59
37;37;2018-03-05 11:56:17.587;2018-03-05 13:17:12.280;81;34;89;55
37;37;2018-03-02 00:59:36.270;2018-03-02 02:17:24.790;78;33;89;56
37;37;2018-02-27 19:53:59.547;2018-02-27 21:10:30.520;77;33;89;56
37;37;2018-02-14 08:08:00.023;2018-02-14 09:51:58.850;103;34;89;55
37;37;2018-02-06 15:11:37.673;2018-02-06 16:59:22.347;108;34;89;55
37;37;2018-04-20 21:25:25.600;2018-04-20 22:51:12.230;86;33;89;56
37;37;2018-03-26 10:40:46.930;2018-03-26 12:48:07.977;128;34;89;55
37;37;2018-03-23 00:07:21.147;2018-03-23 01:50:37.373;103;33;89;56
37;37;2018-03-19 21:28:10.343;2018-03-19 23:01:52.460;93;33;89;56
37;37;2018-02-21 03:38:41.697;2018-02-21 05:04:46.570;86;33;89;56
37;37;2018-02-23 01:28:04.020;2018-02-23 02:54:31.603;86;33;89;56
37;37;2018-02-20 05:09:34.847;2018-02-20 07:32:18.967;143;34;92;58
37;37;2018-02-16 09:59:06.313;2018-02-16 11:58:35.837;119;34;89;55
37;37;2018-02-15 15:56:17.667;2018-02-15 17:50:11.120;114;33;89;56
37;37;2018-01-30 03:09:04.100;2018-01-30 05:30:41.767;141;32;89;57
37;37;2018-01-26 07:44:00.243;2018-01-26 09:42:54.303;118;34;89;55
37;37;2018-01-19 10:19:57.897;2018-01-19 10:22:24.793;3;88;89;1
37;37;2018-01-17 07:15:03.050;2018-01-17 09:06:30.110;111;33;89;56
37;37;2018-01-12 08:52:47.193;2018-01-15 10:31:38.233;4419;32;75;43
37;37;2018-01-15 09:10:03.803;2018-01-15 10:31:38.233;81;34;75;41
37;37;2018-01-08 21:11:20.463;2018-01-08 23:34:52.170;143;34;89;55
37;37;2018-01-08 21:15:40.070;2018-01-08 23:34:52.170;139;34;89;55
37;37;2018-01-04 03:16:58.973;2018-01-04 04:41:31.817;85;52;89;37
37;37;2018-01-04 21:20:59.247;2018-01-04 23:25:26.373;125;33;89;56
37;37;2018-01-03 16:33:12.420;2018-01-03 17:11:07.603;38;69;89;20
37;37;2017-12-26 06:20:17.923;2017-12-26 08:13:19.660;113;31;89;58
37;37;2017-12-15 07:42:36.307;2017-12-15 09:42:29.163;120;34;89;55
37;37;2017-12-11 16:56:50.087;2017-12-11 18:44:43.983;108;33;89;56
37;37;2017-12-04 23:57:29.430;2017-12-05 01:57:45.840;120;31;89;58
37;37;2017-11-23 05:11:43.047;2017-11-23 06:29:30.087;78;34;89;55
37;37;2017-11-22 08:10:26.953;2017-11-22 09:26:57.800;76;34;89;55
37;37;2017-11-20 12:34:03.830;2017-11-21 12:49:37.153;1455;34;89;55
37;37;2017-11-16 03:48:14.533;2017-11-16 05:00:12.540;72;33;89;56
37;37;2017-11-16 03:49:52.887;2017-11-16 05:00:12.540;71;33;89;56
37;37;2017-11-15 09:35:48.740;2017-11-15 09:55:42.383;20;34;47;13
37;37;2017-11-15 09:59:36.700;2017-11-15 10:49:55.157;50;47;89;42
37;37;2017-11-10 09:18:34.820;2017-11-10 11:04:09.823;106;33;89;56
37;37;2017-11-08 11:52:58.210;2017-11-08 14:36:09.113;164;34;89;55
37;37;2017-11-08 11:54:27.660;2017-11-08 14:36:09.113;162;34;89;55
37;37;2017-11-08 11:55:25.370;2017-11-08 14:36:09.113;161;34;89;55
37;37;2017-11-08 11:56:13.427;2017-11-08 14:36:09.113;160;34;89;55
37;37;2017-11-08 11:58:22.530;2017-11-08 14:36:09.113;158;34;89;55
37;37;2017-11-08 13:02:49.167;2017-11-08 14:36:09.113;94;34;89;55
37;37;2017-11-07 07:29:36.537;2017-11-07 07:35:42.553;6;87;89;2
37;37;2017-10-25 03:19:52.417;2017-10-25 07:24:56.410;245;33;100;67
37;37;2017-10-24 09:07:08.873;2017-10-25 07:24:56.410;1337;98;100;2
37;37;2017-10-26 07:18:24.643;2017-10-26 08:29:58.120;71;32;89;57
37;37;2017-10-13 13:04:58.790;2017-10-13 14:14:27.203;70;34;89;55
37;37;2017-10-16 11:59:20.480;2017-10-16 12:57:35.177;58;33;62;29
37;37;2017-10-16 12:21:04.573;2017-10-16 12:57:35.177;36;33;62;29
37;37;2017-10-16 13:38:21.000;2017-10-16 13:44:04.947;6;86;89;3
37;37;2017-10-11 21:19:50.433;2017-10-11 22:45:43.317;86;34;89;55
37;37;2017-10-11 21:26:52.633;2017-10-11 22:45:43.317;79;34;89;55
37;37;2017-10-11 02:41:28.580;2017-10-11 05:06:59.593;145;34;89;55
37;37;2017-10-10 09:09:41.510;2017-10-10 10:27:40.930;78;33;89;56
37;37;2017-10-09 02:53:26.740;2017-10-09 04:05:45.250;72;33;89;56
37;37;2017-10-05 19:14:36.510;2017-10-05 21:44:05.840;150;34;99;65
37;37;2017-10-05 19:30:01.237;2017-10-05 21:44:05.840;134;34;99;65
37;37;2017-10-05 19:36:04.487;2017-10-05 21:44:05.840;128;34;99;65
38;38;2017-10-02 19:07:44.223;2017-10-02 20:34:07.100;87;33;97;64
38;38;2017-10-03 16:17:49.950;2017-10-04 11:30:35.010;1153;33;89;56
38;38;2017-10-03 16:34:48.030;2017-10-04 11:30:35.010;1136;33;89;56
38;38;2017-10-03 16:36:13.710;2017-10-04 11:30:35.010;1134;33;89;56
38;38;2017-10-04 09:39:15.053;2017-10-04 11:30:35.010;111;33;89;56
38;38;2017-10-04 09:42:14.363;2017-10-04 11:30:35.010;108;33;89;56
38;38;2017-10-05 03:51:22.113;2017-10-05 05:10:00.123;79;34;89;55
38;38;2017-10-05 20:29:26.353;2017-10-05 21:31:23.503;62;34;89;55
38;38;2017-10-06 12:51:40.420;2017-10-06 13:55:11.060;64;34;89;55
38;38;2017-10-09 12:18:38.417;2017-10-09 13:26:49.983;68;33;89;56
38;38;2017-10-13 13:58:44.413;2017-10-13 15:17:46.883;79;34;89;55
38;38;2017-10-14 18:01:59.620;2017-10-14 22:34:09.663;273;58;100;42
38;38;2017-10-16 11:25:31.250;2017-10-16 12:40:09.497;75;34;89;55
38;38;2017-10-17 15:06:02.220;2017-10-17 16:22:26.593;76;34;89;55
38;38;2017-10-22 21:55:02.107;2017-10-23 02:32:46.100;277;6;100;94
38;38;2017-10-27 05:19:41.713;2017-10-27 05:58:34.910;39;77;89;12
38;38;2017-10-29 22:16:33.160;2017-10-30 12:30:52.257;854;16;88;72
38;38;2017-10-31 20:37:42.070;2017-10-31 21:48:13.017;71;33;89;56
38;38;2017-11-03 05:32:42.547;2017-11-03 06:55:07.430;83;34;89;55
38;38;2017-11-04 00:15:54.937;2017-11-04 01:58:39.740;103;34;89;55
38;38;2017-11-08 07:15:18.780;2017-11-08 10:01:50.800;166;34;89;55
38;38;2017-11-08 07:18:12.187;2017-11-08 10:01:50.800;163;34;89;55
38;38;2017-11-09 04:39:45.357;2017-11-09 05:46:21.247;67;33;89;56
38;38;2017-11-13 05:40:52.680;2017-11-13 06:39:23.630;59;34;89;55
37;37;2017-10-05 02:43:27.980;2017-10-05 04:14:50.117;91;30;89;59
37;37;2017-10-04 11:51:24.547;2017-10-04 12:33:17.463;42;33;65;32
37;37;2017-10-02 17:36:50.270;2017-10-04 12:33:17.463;2577;33;65;32
37;37;2018-06-09 04:37:49.990;2018-06-09 06:03:00.850;86;32;89;57
37;37;2018-06-07 11:11:21.920;2018-06-07 12:28:38.840;77;33;89;56
37;37;2018-05-24 23:06:05.807;2018-05-25 01:33:23.113;147;33;89;56
37;37;2018-05-23 23:29:17.330;2018-05-24 01:42:53.480;133;34;89;55
37;37;2018-05-16 19:38:30.343;2018-05-16 21:21:15.477;103;33;89;56
37;37;2018-04-25 06:12:37.607;2018-04-25 07:38:49.743;86;34;89;55
37;37;2018-03-12 15:37:15.583;2018-03-12 16:59:24.173;82;34;89;55
37;37;2018-05-04 14:30:45.813;2018-05-04 15:13:30.773;43;34;61;27
37;37;2018-05-02 22:25:48.343;2018-05-02 23:46:04.780;81;33;89;56
37;37;2018-04-12 12:29:21.860;2018-04-12 12:33:12.860;4;75;78;3
37;37;2018-04-05 23:09:25.413;2018-04-06 00:36:21.970;87;34;89;55
37;37;2018-04-10 05:12:15.717;2018-04-10 06:55:03.420;103;34;89;55
37;37;2018-04-03 21:08:19.670;2018-04-03 22:31:24.640;83;32;89;57
37;37;2018-03-13 08:28:24.853;2018-03-13 09:52:01.500;84;34;89;55
37;37;2018-03-07 00:28:47.013;2018-03-07 01:50:05.130;82;33;89;56
37;37;2018-02-13 10:03:38.680;2018-02-13 11:45:04.387;102;34;89;55
37;37;2018-02-12 11:31:43.873;2018-02-12 13:07:29.707;96;34;89;55
37;37;2018-02-09 06:31:03.363;2018-02-09 08:58:11.887;147;34;89;55
37;37;2018-02-07 10:38:46.230;2018-02-07 12:28:03.180;110;34;89;55
37;37;2018-04-18 23:33:49.130;2018-04-19 02:42:31.863;189;34;89;55
37;37;2018-02-05 07:55:05.593;2018-02-05 13:54:20.260;359;34;100;66
37;37;2018-03-23 16:19:47.540;2018-03-23 18:05:20.683;106;34;89;55
37;37;2018-03-16 08:34:02.587;2018-03-16 10:05:56.850;91;33;89;56
37;37;2018-03-14 22:39:36.090;2018-03-15 00:05:38.933;86;34;89;55
37;37;2018-02-22 12:36:20.740;2018-02-23 02:54:31.603;858;33;89;56
37;37;2018-02-26 05:12:05.913;2018-02-26 07:14:01.580;122;17;89;72
37;37;2018-02-26 05:13:20.893;2018-02-26 07:14:01.580;121;16;89;73
37;37;2018-02-01 18:59:08.047;2018-02-01 20:47:06.683;108;33;89;56
37;37;2018-01-30 03:05:28.743;2018-01-30 05:30:41.767;145;33;89;56
37;37;2018-01-29 07:41:26.697;2018-01-29 09:50:24.920;129;34;89;55
37;37;2018-01-15 09:12:07.380;2018-01-15 10:31:38.233;79;34;75;41
37;37;2018-01-11 07:07:56.397;2018-01-11 08:59:17.133;112;34;89;55
37;37;2018-01-04 21:23:14.710;2018-01-04 23:25:26.373;122;33;89;56
37;37;2017-12-21 07:33:48.753;2017-12-21 09:01:20.507;88;34;77;43
37;37;2017-12-28 06:56:13.377;2017-12-28 08:47:09.940;111;33;89;56
37;37;2017-12-28 06:57:50.773;2017-12-28 08:47:09.940;110;33;89;56
37;37;2017-12-21 20:11:16.423;2017-12-21 22:15:33.373;124;33;89;56
37;37;2017-12-19 01:25:37.217;2017-12-19 07:13:13.910;348;33;100;67
37;37;2017-12-18 07:11:33.067;2017-12-18 10:32:12.927;201;17;91;74
37;37;2017-12-13 20:14:04.490;2017-12-13 22:06:49.407;112;34;89;55
37;37;2017-12-12 09:51:33.377;2017-12-12 11:43:30.047;112;34;89;55
37;37;2017-12-05 05:43:57.760;2017-12-05 05:59:48.193;16;80;89;9
37;37;2017-12-09 09:20:41.680;2017-12-09 11:33:11.603;133;33;89;56
37;37;2017-12-07 03:54:51.490;2017-12-07 05:45:02.500;111;34;89;55
37;37;2017-12-02 16:00:58.790;2017-12-02 19:50:36.833;230;84;100;16
37;37;2017-12-02 09:28:20.563;2017-12-02 11:31:12.043;123;33;89;56
37;37;2017-11-16 18:45:00.063;2017-11-17 14:10:33.600;1165;34;89;55
37;37;2017-11-20 12:30:04.027;2017-11-21 12:49:37.153;1459;34;89;55
37;37;2017-11-14 07:18:33.793;2017-11-14 08:07:13.770;49;33;76;43
37;37;2017-11-08 11:59:51.433;2017-11-08 14:36:09.113;157;34;89;55
37;37;2017-11-08 12:01:53.210;2017-11-08 14:36:09.113;155;34;89;55
37;37;2017-11-03 09:24:53.923;2017-11-03 10:58:59.877;94;34;89;55
37;37;2017-11-03 09:38:41.607;2017-11-03 10:58:59.877;80;34;89;55
37;37;2017-11-02 13:29:33.240;2017-11-02 15:09:49.927;100;16;89;73
37;37;2017-10-31 09:59:45.467;2017-10-31 11:13:33.290;74;34;89;55
37;37;2017-10-30 19:03:33.883;2017-10-30 20:10:49.103;67;34;89;55
37;37;2017-10-29 22:11:55.860;2017-10-30 02:52:12.850;281;15;100;85
37;37;2017-10-27 03:42:57.743;2017-10-27 04:56:10.310;74;34;89;55
37;37;2017-10-26 07:19:59.643;2017-10-26 08:29:58.120;70;32;89;57
37;37;2017-10-24 07:58:37.020;2017-10-24 08:05:52.067;7;91;95;4
37;37;2017-10-24 08:09:28.607;2017-10-24 09:06:19.970;57;95;98;3
37;37;2017-10-19 18:40:54.913;2017-10-19 19:54:07.727;74;33;89;56
37;37;2017-10-18 04:21:03.157;2017-10-18 05:33:20.920;72;33;89;56
37;37;2017-10-13 12:53:04.903;2017-10-13 14:14:27.203;81;34;89;55
37;37;2017-10-17 03:29:10.970;2017-10-17 08:19:12.790;290;33;89;56
37;37;2017-10-17 10:29:46.503;2017-10-17 10:30:25.287;1;88;89;1
37;37;2017-10-16 12:07:09.010;2017-10-16 12:57:35.177;50;33;62;29
37;37;2017-10-16 12:12:00.710;2017-10-16 12:57:35.177;45;33;62;29
37;37;2017-10-16 12:22:36.760;2017-10-16 12:57:35.177;35;33;62;29
37;37;2017-10-11 21:32:07.397;2017-10-11 22:45:43.317;73;34;89;55
37;37;2017-10-11 02:14:26.203;2017-10-11 05:06:59.593;172;34;89;55
37;37;2017-10-11 03:53:23.213;2017-10-11 05:06:59.593;73;34;89;55
37;37;2017-10-09 16:58:15.557;2017-10-09 18:09:13.747;71;34;89;55
37;37;2017-10-08 23:29:59.727;2017-10-09 04:05:45.250;276;33;89;56
37;37;2017-10-05 18:39:21.660;2017-10-05 21:44:05.840;185;34;99;65
37;37;2017-10-05 19:12:27.200;2017-10-05 21:44:05.840;152;34;99;65
38;38;2017-10-02 19:01:35.190;2017-10-02 20:34:07.100;93;33;97;64
38;38;2017-10-02 19:02:43.593;2017-10-02 20:34:07.100;92;33;97;64
38;38;2017-10-03 16:21:48.437;2017-10-04 11:30:35.010;1149;33;89;56
38;38;2017-10-03 16:24:53.860;2017-10-04 11:30:35.010;1146;33;89;56
38;38;2017-10-03 16:38:57.827;2017-10-04 11:30:35.010;1132;33;89;56
38;38;2017-10-04 09:35:13.293;2017-10-04 11:30:35.010;115;33;89;56
38;38;2017-10-04 09:41:30.547;2017-10-04 11:30:35.010;109;33;89;56
38;38;2017-10-04 10:18:22.763;2017-10-04 11:30:35.010;72;33;89;56
38;38;2017-10-16 23:55:11.100;2017-10-17 01:06:35.480;71;34;89;55
38;38;2017-10-18 11:51:33.860;2017-10-18 12:52:44.613;61;33;89;56
38;38;2017-10-20 04:18:16.250;2017-10-20 05:25:38.617;67;33;89;56
38;38;2017-10-24 12:11:31.447;2017-10-24 12:23:15.060;12;82;89;7
38;38;2017-10-29 22:21:56.640;2017-10-30 12:30:52.257;849;16;88;72
38;38;2017-10-30 08:44:50.530;2017-10-30 12:30:52.257;226;16;88;72
38;38;2017-10-30 08:49:46.680;2017-10-30 12:30:52.257;221;16;88;72
38;38;2017-10-31 01:18:43.050;2017-10-31 04:14:06.873;176;34;91;57
38;38;2017-10-31 20:41:11.820;2017-10-31 21:48:13.017;67;33;89;56
38;38;2017-11-06 16:01:06.980;2017-11-06 17:58:31.200;117;34;89;55
38;38;2017-11-06 16:03:23.710;2017-11-06 17:58:31.200;115;34;89;55
38;38;2017-11-07 09:56:07.393;2017-11-07 15:23:02.683;327;34;89;55
38;38;2017-11-09 04:24:57.823;2017-11-09 05:46:21.247;82;33;89;56
38;38;2017-11-13 05:37:21.570;2017-11-13 06:39:23.630;62;34;89;55
38;38;2017-11-13 18:32:38.420;2017-11-13 19:35:19.320;63;34;89;55
38;38;2017-11-15 10:26:36.940;2017-11-15 11:35:06.093;69;31;89;58
38;38;2017-11-23 12:38:51.323;2017-11-23 13:41:06.333;63;33;89;56
38;38;2017-11-24 07:36:02.300;2017-11-24 08:44:21.430;68;33;89;56
38;38;2017-11-27 12:44:32.170;2017-11-27 15:24:50.730;160;34;89;55
38;38;2017-11-27 13:31:10.723;2017-11-27 15:24:50.730;113;34;89;55
38;38;2017-11-29 02:58:53.070;2017-11-29 05:04:48.943;126;34;89;55
38;38;2017-12-01 10:07:31.247;2017-12-01 13:12:49.400;185;30;89;59
38;38;2017-12-02 18:02:31.773;2017-12-02 22:28:00.400;266;49;100;51
38;38;2017-12-05 18:08:53.343;2017-12-05 20:13:25.037;125;33;89;56
38;38;2017-12-07 11:14:48.697;2017-12-07 14:03:36.913;169;34;89;55
38;38;2017-12-08 03:46:18.967;2017-12-09 22:40:20.753;2574;62;100;38
38;38;2017-12-12 22:48:19.383;2017-12-13 00:51:11.070;123;33;89;56
37;37;2017-10-05 02:49:46.587;2017-10-05 04:14:50.117;85;30;89;59
37;37;2017-10-04 11:52:47.930;2017-10-04 12:33:17.463;41;33;65;32
37;37;2017-10-02 17:46:18.717;2017-10-04 12:33:17.463;2567;33;65;32
38;38;2017-12-14 10:43:47.537;2017-12-14 13:04:59.130;141;34;91;57
38;38;2017-12-15 09:30:39.210;2017-12-15 11:16:11.507;106;34;89;55
38;38;2017-12-20 03:09:10.587;2017-12-20 05:25:08.487;136;34;89;55
38;38;2017-12-20 03:23:29.387;2017-12-20 05:25:08.487;122;34;89;55
38;38;2017-12-19 07:50:45.960;2017-12-19 09:09:42.653;79;33;70;37
38;38;2017-12-26 08:36:29.093;2017-12-26 10:48:47.020;132;34;81;47
38;38;2017-12-26 08:49:00.030;2017-12-26 10:48:47.020;119;34;81;47
38;38;2017-12-30 18:01:02.070;2018-01-02 02:56:18.860;3415;70;100;30
38;38;2018-01-08 09:10:54.783;2018-01-08 09:44:57.197;34;33;37;4
38;38;2018-01-11 10:25:18.987;2018-01-11 12:18:00.247;113;34;89;55
38;38;2018-01-15 11:14:22.880;2018-01-15 13:26:24.797;132;34;89;55
38;38;2018-01-16 08:30:22.230;2018-01-16 15:04:45.657;394;34;89;55
38;38;2018-02-14 12:00:25.280;2018-02-14 13:17:51.417;77;33;84;51
37;37;2018-04-27 13:11:03.077;2018-04-27 14:47:32.630;96;34;89;55
37;37;2018-04-25 19:07:44.560;2018-04-25 20:38:09.057;91;33;89;56
37;37;2018-05-04 02:19:21.140;2018-05-04 03:41:18.753;82;33;89;56
37;37;2018-05-03 11:20:30.190;2018-05-03 12:39:33.733;79;34;89;55
37;37;2018-04-16 11:39:48.850;2018-04-16 14:33:16.403;174;34;89;55
37;37;2018-04-14 05:32:15.790;2018-04-14 07:42:21.540;130;33;89;56
37;37;2018-04-09 11:07:38.100;2018-04-09 12:44:59.527;97;34;89;55
37;37;2018-04-02 23:22:51.537;2018-04-03 02:22:59.687;180;34;89;55
37;37;2018-03-07 21:26:51.057;2018-03-07 22:49:57.167;83;32;89;57
37;37;2018-03-02 19:48:36.030;2018-03-02 21:06:58.817;78;33;89;56
37;37;2018-02-07 10:37:07.900;2018-02-07 12:28:03.180;111;34;89;55
37;37;2018-02-05 07:56:16.127;2018-02-05 13:54:20.260;358;34;100;66
37;37;2018-02-05 07:46:03.207;2018-02-05 13:54:20.260;368;34;100;66
37;37;2018-02-05 07:48:06.897;2018-02-05 13:54:20.260;366;34;100;66
37;37;2018-04-19 23:53:41.397;2018-04-20 01:15:57.307;82;34;89;55
37;37;2018-04-17 08:11:33.047;2018-04-17 11:03:42.427;172;33;89;56
37;37;2018-03-22 07:02:14.060;2018-03-22 08:43:07.350;101;34;89;55
37;37;2018-03-21 09:55:50.787;2018-03-21 11:35:38.120;100;34;89;55
37;37;2018-03-15 14:50:52.243;2018-03-15 16:20:12.803;90;33;89;56
37;37;2018-02-21 20:33:51.713;2018-02-21 21:55:53.370;82;33;89;56
37;37;2018-02-19 08:44:13.310;2018-02-19 11:11:19.957;147;34;89;55
37;37;2018-02-01 04:21:27.717;2018-02-01 06:07:52.883;106;33;89;56
37;37;2018-02-03 05:11:30.067;2018-02-03 06:40:28.790;89;42;89;47
37;37;2018-01-31 06:27:37.080;2018-01-31 08:13:32.183;106;33;89;56
37;37;2018-01-22 11:58:30.623;2018-01-22 13:47:08.020;109;34;89;55
37;37;2018-01-29 07:43:55.417;2018-01-29 09:50:24.920;127;34;89;55
37;37;2018-01-25 11:51:46.753;2018-01-25 13:29:14.823;98;33;79;46
37;37;2018-01-19 07:21:29.707;2018-01-19 09:15:59.897;114;33;89;56
37;37;2018-01-18 06:41:07.533;2018-01-18 08:31:56.643;110;33;89;56
37;37;2018-01-17 07:19:43.377;2018-01-17 09:06:30.110;107;33;89;56
37;37;2018-01-10 10:34:41.127;2018-01-10 12:20:41.573;106;34;89;55
37;37;2018-01-11 07:10:24.527;2018-01-11 08:59:17.133;109;34;89;55
37;37;2018-01-09 15:03:29.730;2018-01-09 17:05:09.400;122;33;86;53
37;37;2018-01-08 04:16:57.070;2018-01-08 06:43:00.557;147;26;89;63
37;37;2017-12-29 05:22:07.623;2017-12-29 07:08:25.347;106;33;89;56
37;37;2018-01-03 15:11:34.407;2018-01-03 16:31:17.330;80;33;70;37
37;37;2018-01-02 08:49:31.373;2018-01-02 10:31:09.270;102;33;82;49
37;37;2017-12-30 16:01:58.750;2017-12-30 21:35:56.647;334;40;100;60
37;37;2017-12-09 16:01:33.830;2017-12-09 20:28:56.460;267;83;100;17
37;37;2017-12-09 09:23:29.987;2017-12-09 11:33:11.603;130;32;89;57
37;37;2017-11-25 16:00:59.047;2017-11-25 21:44:30.753;344;55;100;45
37;37;2017-11-13 12:05:30.740;2017-11-13 14:20:46.133;135;34;89;55
37;37;2017-11-13 12:13:59.830;2017-11-13 14:20:46.133;127;34;89;55
37;37;2017-11-14 07:11:02.997;2017-11-14 08:07:13.770;56;33;76;43
37;37;2017-11-14 15:44:38.467;2017-11-14 16:53:16.097;69;33;89;56
37;37;2017-11-15 09:37:23.513;2017-11-15 09:55:42.383;18;34;47;13
37;37;2017-11-08 12:09:05.200;2017-11-08 14:36:09.113;147;34;89;55
37;37;2017-11-07 20:04:38.697;2017-11-07 21:36:03.840;92;33;89;56
37;37;2017-11-06 11:05:21.810;2017-11-06 12:05:20.000;60;55;89;34
37;37;2017-10-31 10:02:28.623;2017-10-31 11:13:33.290;71;34;89;55
37;37;2017-10-29 22:13:47.760;2017-10-30 02:52:12.850;279;15;100;85
37;37;2017-10-27 03:38:27.480;2017-10-27 04:56:10.310;78;34;89;55
37;37;2017-10-23 06:16:10.410;2017-10-23 10:04:51.657;228;30;99;69
37;37;2017-10-17 11:38:32.603;2017-10-17 11:39:21.027;1;88;89;1
37;37;2017-10-17 09:38:39.550;2017-10-17 09:40:44.790;2;87;89;2
37;37;2017-10-16 12:57:39.780;2017-10-16 13:34:29.063;37;62;84;22
37;37;2017-10-11 21:20:56.033;2017-10-11 22:45:43.317;85;34;89;55
37;37;2017-10-11 21:30:22.237;2017-10-11 22:45:43.317;75;34;89;55
37;37;2017-10-10 09:14:49.877;2017-10-10 10:27:40.930;73;33;89;56
37;37;2017-10-05 18:58:58.870;2017-10-05 21:44:05.840;166;34;99;65
37;37;2017-10-05 19:35:09.020;2017-10-05 21:44:05.840;129;34;99;65
38;38;2017-10-02 19:00:44.293;2017-10-02 20:34:07.100;94;0;97;97
38;38;2017-10-02 19:02:24.163;2017-10-02 20:34:07.100;92;33;97;64
38;38;2017-10-03 16:13:55.937;2017-10-04 11:30:35.010;1157;33;89;56
38;38;2017-10-03 16:16:22.753;2017-10-04 11:30:35.010;1154;33;89;56
38;38;2017-10-03 16:19:43.590;2017-10-04 11:30:35.010;1151;33;89;56
38;38;2017-10-03 16:32:07.340;2017-10-04 11:30:35.010;1138;33;89;56
38;38;2017-10-04 09:37:52.233;2017-10-04 11:30:35.010;113;33;89;56
38;38;2017-10-04 10:16:50.757;2017-10-04 11:30:35.010;74;33;89;56
38;38;2017-10-05 03:52:08.023;2017-10-05 05:10:00.123;78;34;89;55
38;38;2017-10-05 03:55:13.113;2017-10-05 05:10:00.123;75;34;89;55
38;38;2017-10-10 02:17:55.567;2017-10-10 03:27:58.850;70;33;89;56
38;38;2017-10-11 09:49:17.913;2017-10-11 10:23:11.993;34;64;89;25
38;38;2017-10-16 11:32:11.730;2017-10-16 12:40:09.497;68;34;89;55
38;38;2017-10-17 15:07:56.213;2017-10-17 16:22:26.593;75;34;89;55
38;38;2017-10-26 04:22:32.980;2017-10-26 05:46:29.440;84;33;89;56
38;38;2017-10-27 04:24:24.303;2017-10-27 05:19:11.407;55;34;77;43
38;38;2017-10-29 22:17:39.610;2017-10-30 12:30:52.257;853;16;88;72
38;38;2017-10-29 22:20:48.610;2017-10-30 12:30:52.257;850;16;88;72
38;38;2017-10-30 08:46:08.487;2017-10-30 12:30:52.257;224;16;88;72
38;38;2017-10-30 08:50:49.183;2017-10-30 12:30:52.257;220;16;88;72
38;38;2017-11-02 09:14:02.097;2017-11-02 10:27:12.910;73;33;89;56
38;38;2017-11-08 07:14:26.050;2017-11-08 10:01:50.800;167;34;89;55
38;38;2017-11-08 07:16:38.183;2017-11-08 10:01:50.800;165;34;89;55
37;37;2017-10-02 17:42:23.310;2017-10-04 12:33:17.463;2571;33;65;32
37;37;2017-10-02 17:49:00.533;2017-10-04 12:33:17.463;2564;33;65;32
37;37;2017-10-02 18:17:26.577;2017-10-04 12:33:17.463;2536;33;65;32
37;37;2017-10-02 18:21:34.970;2017-10-04 12:33:17.463;2532;33;65;32
38;38;2017-11-14 10:17:53.133;2017-11-15 11:35:06.093;1518;34;89;55
38;38;2017-11-17 16:21:30.447;2017-11-17 17:32:03.580;71;33;89;56
38;38;2017-11-21 04:53:36.940;2017-11-21 06:29:57.203;96;34;89;55
38;38;2017-11-21 20:42:25.497;2017-11-21 22:24:07.637;102;34;89;55
38;38;2017-11-21 20:43:59.003;2017-11-21 22:24:07.637;101;34;89;55
38;38;2017-11-22 15:11:35.797;2017-11-22 16:45:14.210;94;34;87;53
38;38;2017-11-24 07:32:21.267;2017-11-24 08:44:21.430;72;33;89;56
38;38;2017-11-24 07:37:32.673;2017-11-24 08:44:21.430;67;33;89;56
38;38;2017-11-25 18:02:29.917;2017-11-25 23:23:05.020;321;37;100;63
38;38;2017-11-27 13:35:35.103;2017-11-27 15:24:50.730;109;34;89;55
38;38;2017-11-28 09:50:24.220;2017-11-28 11:41:17.937;111;34;89;55
38;38;2017-11-29 02:50:11.017;2017-11-29 05:04:48.943;134;34;89;55
38;38;2017-12-08 03:46:21.317;2017-12-09 22:40:20.753;2574;62;100;38
38;38;2017-12-09 18:01:42.230;2017-12-09 22:40:20.753;279;46;100;54
38;38;2017-12-12 07:13:48.570;2017-12-12 09:09:05.390;116;34;89;55
38;38;2017-12-18 13:00:36.383;2017-12-18 14:45:23.163;105;34;89;55
38;38;2017-12-22 00:09:07.160;2017-12-22 03:43:19.703;214;34;89;55
38;38;2017-12-22 00:40:27.823;2017-12-22 03:43:19.703;183;34;89;55
38;38;2017-12-26 08:46:25.323;2017-12-26 10:48:47.020;122;34;81;47
38;38;2017-12-26 08:56:11.890;2017-12-26 10:48:47.020;112;34;81;47
38;38;2017-12-26 09:01:50.797;2017-12-26 10:48:47.020;107;34;81;47
38;38;2017-12-29 23:54:12.100;2017-12-30 02:03:03.283;129;33;89;56
38;38;2018-01-05 08:33:43.907;2018-01-05 10:35:41.493;122;33;89;56
38;38;2018-01-08 09:52:13.010;2018-01-08 15:37:45.000;345;37;89;52
38;38;2018-01-08 12:33:42.533;2018-01-08 15:37:45.000;184;34;89;55
38;38;2018-01-09 09:17:16.920;2018-01-09 13:05:39.350;228;34;88;54
38;38;2018-01-10 11:36:30.490;2018-01-10 13:23:25.423;107;33;89;56
38;38;2018-01-16 08:34:10.360;2018-01-16 15:04:45.657;390;34;89;55
38;38;2018-01-16 08:37:03.970;2018-01-16 15:04:45.657;387;34;89;55
38;38;2018-01-18 11:08:51.460;2018-01-18 12:21:49.717;73;34;69;35
38;38;2018-01-19 16:14:04.957;2018-01-19 19:34:40.977;200;33;89;56
38;38;2018-01-24 01:15:19.467;2018-01-24 03:05:34.203;110;34;89;55
38;38;2018-02-07 20:09:27.283;2018-02-07 22:10:27.843;121;34;89;55
38;38;2018-02-13 15:12:31.910;2018-02-13 16:38:14.017;86;34;89;55
38;38;2018-02-14 11:58:34.177;2018-02-14 13:17:51.417;79;33;84;51
38;38;2018-02-14 13:19:12.383;2018-02-14 13:34:07.813;15;84;89;5
38;38;2018-02-28 06:30:28.770;2018-02-28 07:55:01.540;85;33;89;56
38;38;2018-02-28 20:24:10.440;2018-02-28 21:46:12.807;82;34;89;55
38;38;2018-03-01 14:34:29.593;2018-03-01 16:00:04.473;86;33;89;56
37;37;2018-02-09 06:35:13.680;2018-02-09 08:58:11.887;143;34;89;55
37;37;2018-02-09 06:59:25.493;2018-02-09 08:58:11.887;119;34;89;55
37;37;2018-02-08 12:06:01.880;2018-02-08 13:57:26.910;111;33;89;56
37;37;2018-02-05 07:57:41.217;2018-02-05 13:54:20.260;357;34;100;66
37;37;2018-04-18 05:22:05.937;2018-04-18 08:19:34.527;177;34;89;55
37;37;2018-03-27 09:50:29.627;2018-03-27 11:59:22.307;129;34;89;55
37;37;2018-04-02 07:10:33.930;2018-04-02 10:20:25.527;190;22;89;67
37;37;2018-03-20 14:34:59.653;2018-03-20 16:11:32.427;97;34;89;55
37;37;2018-03-19 07:36:31.860;2018-03-19 09:08:07.953;92;34;89;55
37;37;2018-03-14 06:48:48.697;2018-03-14 08:16:22.940;88;33;89;56
37;37;2018-02-27 05:07:11.287;2018-02-27 06:27:32.797;80;30;89;59
37;37;2018-02-23 01:29:47.260;2018-02-23 02:54:31.603;85;33;89;56
37;37;2018-02-20 05:05:47.493;2018-02-20 07:32:18.967;147;34;92;58
37;37;2018-01-26 07:41:05.930;2018-01-26 09:42:54.303;121;34;89;55
37;37;2018-01-23 09:15:11.133;2018-01-23 11:06:44.830;111;34;89;55
37;37;2018-01-24 11:40:02.540;2018-01-24 13:53:14.020;133;33;89;56
37;37;2018-01-19 18:12:11.853;2018-01-19 18:29:37.990;17;80;89;9
37;37;2018-01-19 07:25:43.883;2018-01-19 09:15:59.897;110;33;89;56
37;37;2018-01-16 05:39:07.720;2018-01-16 07:24:26.007;105;33;89;56
37;37;2018-01-09 15:09:08.547;2018-01-09 17:05:09.400;116;33;86;53
37;37;2018-01-02 22:00:04.870;2018-01-02 23:53:32.257;113;34;89;55
37;37;2018-01-02 08:53:32.713;2018-01-02 10:31:09.270;98;33;82;49
37;37;2017-12-20 10:15:48.790;2017-12-20 12:06:02.803;111;33;89;56
37;37;2017-12-14 12:47:48.167;2017-12-14 14:45:17.190;118;34;89;55
37;37;2017-12-13 05:07:11.513;2017-12-13 06:58:58.420;111;34;89;55
37;37;2017-12-09 09:22:07.527;2017-12-09 11:33:11.603;131;32;89;57
37;37;2017-12-01 15:17:29.373;2017-12-01 15:56:47.013;39;34;50;16
37;37;2017-11-17 12:02:29.750;2017-11-17 14:10:33.600;128;34;89;55
37;37;2017-11-17 12:19:27.750;2017-11-17 14:10:33.600;111;34;89;55
37;37;2017-11-17 12:55:21.933;2017-11-17 14:10:33.600;75;32;89;57
37;37;2017-11-16 18:44:12.873;2017-11-17 14:10:33.600;1166;34;89;55
37;37;2017-11-16 18:48:19.490;2017-11-17 14:10:33.600;1162;34;89;55
37;37;2017-11-21 11:32:13.420;2017-11-21 12:49:37.153;77;34;89;55
37;37;2017-11-20 12:34:50.787;2017-11-21 12:49:37.153;1455;34;89;55
37;37;2017-11-20 12:37:38.740;2017-11-21 12:49:37.153;1452;34;89;55
37;37;2017-11-06 08:15:05.677;2017-11-06 08:47:11.550;32;34;58;24
37;37;2017-11-14 15:28:21.817;2017-11-14 16:53:16.097;85;33;89;56
37;37;2017-11-15 09:56:08.030;2017-11-15 10:49:55.157;53;47;89;42
37;37;2017-11-09 13:39:11.790;2017-11-09 15:22:07.607;103;33;89;56
37;37;2017-11-08 12:01:06.253;2017-11-08 14:36:09.113;155;34;89;55
37;37;2017-11-08 12:03:46.110;2017-11-08 14:36:09.113;153;34;89;55
37;37;2017-11-08 12:12:36.067;2017-11-08 14:36:09.113;144;34;89;55
37;37;2017-11-08 12:18:47.403;2017-11-08 14:36:09.113;138;34;89;55
37;37;2017-11-07 06:04:26.513;2017-11-07 07:24:36.060;80;34;87;53
37;37;2017-11-02 13:28:30.370;2017-11-02 15:09:49.927;101;16;89;73
37;37;2017-11-01 13:55:57.590;2017-11-02 15:09:49.927;1514;32;89;57
37;37;2017-10-24 06:42:28.613;2017-10-24 07:56:16.023;74;34;92;58
37;37;2017-10-24 08:07:13.223;2017-10-24 09:06:19.970;59;95;98;3
37;37;2017-10-20 16:25:17.913;2017-10-20 17:50:59.740;85;31;89;58
37;37;2017-10-20 16:35:07.567;2017-10-20 17:50:59.740;75;31;89;58
37;37;2017-10-18 18:40:02.670;2017-10-18 19:52:00.333;72;34;89;55
37;37;2017-10-13 17:16:31.170;2017-10-13 17:21:43.590;5;86;89;3
37;37;2017-10-17 07:01:34.463;2017-10-17 08:19:12.790;78;33;89;56
37;37;2017-10-17 10:17:40.707;2017-10-17 10:19:28.330;2;87;89;2
37;37;2017-10-17 11:08:25.180;2017-10-17 11:09:25.310;1;88;89;1
37;37;2017-10-16 12:01:53.420;2017-10-16 12:57:35.177;56;33;62;29
37;37;2017-10-16 12:05:45.140;2017-10-16 12:57:35.177;52;33;62;29
37;37;2017-10-16 13:04:47.010;2017-10-16 13:34:29.063;30;61;84;23
37;37;2017-10-16 13:34:45.737;2017-10-16 13:37:20.297;3;84;86;2
37;37;2017-10-11 21:29:44.740;2017-10-11 22:45:43.317;76;34;89;55
37;37;2017-10-11 02:41:24.520;2017-10-11 05:06:59.593;145;34;89;55
37;37;2017-10-11 03:01:08.430;2017-10-11 05:06:59.593;125;34;89;55
37;37;2017-10-05 19:42:28.430;2017-10-05 21:44:05.840;122;34;99;65
38;38;2017-10-02 19:01:09.490;2017-10-02 20:34:07.100;93;33;97;64
38;38;2017-10-02 19:01:55.273;2017-10-02 20:34:07.100;93;33;97;64
38;38;2017-10-02 19:04:52.710;2017-10-02 20:34:07.100;90;33;97;64
38;38;2017-10-04 09:36:10.020;2017-10-04 11:30:35.010;114;33;89;56
38;38;2017-10-04 09:44:08.390;2017-10-04 11:30:35.010;106;33;89;56
38;38;2017-10-10 13:14:35.370;2017-10-10 14:25:11.983;71;33;89;56
38;38;2017-10-11 09:09:37.487;2017-10-11 09:49:00.670;40;34;64;30
38;38;2017-10-12 23:33:06.520;2017-10-13 00:46:26.140;73;34;89;55
38;38;2017-10-16 11:23:03.760;2017-10-16 12:40:09.497;77;34;89;55
38;38;2017-10-16 11:31:30.927;2017-10-16 12:40:09.497;69;34;89;55
38;38;2017-10-16 11:33:17.140;2017-10-16 12:40:09.497;67;34;89;55
38;38;2017-10-19 08:05:43.257;2017-10-19 09:09:58.180;64;33;89;56
38;38;2017-10-23 19:40:33.140;2017-10-23 20:46:19.857;66;34;89;55
38;38;2017-10-24 11:12:41.520;2017-10-24 12:09:56.087;57;34;82;48
38;38;2017-10-25 05:25:49.297;2017-10-25 06:37:26.583;72;34;89;55
38;38;2017-10-26 04:21:31.157;2017-10-26 05:46:29.440;85;33;89;56
38;38;2017-10-30 08:47:27.717;2017-10-30 12:30:52.257;223;16;88;72
38;38;2017-10-30 08:48:40.953;2017-10-30 12:30:52.257;222;16;88;72
38;38;2017-11-04 00:30:05.887;2017-11-04 01:58:39.740;88;34;89;55
38;38;2017-11-07 10:21:36.617;2017-11-07 15:23:02.683;302;36;89;53
38;38;2017-11-07 13:13:18.557;2017-11-07 15:23:02.683;130;33;89;56
38;38;2017-11-07 13:15:36.187;2017-11-07 15:23:02.683;128;33;89;56
38;38;2017-11-09 11:58:17.310;2017-11-09 12:09:10.977;11;82;89;7
38;38;2017-11-09 22:37:14.770;2017-11-09 22:55:18.623;18;77;89;12
37;37;2017-10-05 02:52:26.690;2017-10-05 04:14:50.117;82;30;89;59
37;37;2017-10-05 02:53:22.357;2017-10-05 04:14:50.117;81;30;89;59
37;37;2017-10-05 02:58:02.500;2017-10-05 04:14:50.117;76;30;89;59
37;37;2017-10-05 03:01:37.907;2017-10-05 04:14:50.117;73;30;89;59
37;37;2017-10-02 17:40:06.207;2017-10-04 12:33:17.463;2573;33;65;32
37;37;2017-10-02 17:45:26.440;2017-10-04 12:33:17.463;2568;33;65;32
37;37;2017-10-02 17:47:17.440;2017-10-04 12:33:17.463;2566;33;65;32
38;38;2017-11-21 04:55:35.480;2017-11-21 06:29:57.203;94;34;89;55
38;38;2017-12-04 13:22:27.843;2017-12-04 14:58:14.617;96;34;89;55
38;38;2017-12-07 23:56:52.973;2017-12-09 22:40:20.753;2804;67;100;33
38;38;2017-12-12 07:18:10.433;2017-12-12 09:09:05.390;111;34;89;55
38;38;2017-12-20 03:24:48.470;2017-12-20 05:25:08.487;121;34;89;55
38;38;2017-12-20 21:23:39.130;2017-12-21 09:19:50.840;716;33;83;50
38;38;2017-12-21 07:15:09.130;2017-12-21 09:19:50.840;124;31;83;52
38;38;2017-12-21 09:20:30.900;2017-12-21 10:00:49.700;40;83;89;6
38;38;2017-12-26 08:43:04.933;2017-12-26 10:48:47.020;125;34;81;47
38;38;2017-12-26 10:48:54.423;2017-12-26 12:20:22.937;92;81;92;11
38;38;2017-12-27 06:41:24.330;2017-12-27 08:27:28.337;106;34;89;55
38;38;2017-12-27 20:21:14.780;2017-12-27 22:09:31.423;108;34;89;55
38;38;2017-12-28 12:56:01.347;2017-12-28 14:46:21.880;110;34;89;55
38;38;2018-01-01 21:58:30.370;2018-01-02 02:56:18.860;298;32;100;68
38;38;2018-01-16 12:00:39.110;2018-01-16 15:04:45.657;184;34;89;55
38;38;2018-01-16 12:23:16.047;2018-01-16 15:04:45.657;161;34;89;55
38;38;2018-01-16 12:35:34.473;2018-01-16 15:04:45.657;149;34;89;55
38;38;2018-01-19 16:39:32.193;2018-01-19 19:34:40.977;175;33;89;56
38;38;2018-01-22 04:06:53.300;2018-01-22 08:05:23.383;239;34;92;58
38;38;2018-01-25 05:13:50.603;2018-01-25 07:10:35.047;117;34;93;59
38;38;2018-02-07 20:03:01.207;2018-02-07 22:10:27.843;127;34;89;55
38;38;2018-02-11 22:42:30.717;2018-02-12 03:30:56.627;288;31;93;62
38;38;2018-02-28 06:32:56.857;2018-02-28 07:55:01.540;83;33;89;56
38;38;2018-03-01 14:26:03.403;2018-03-01 16:00:04.473;94;33;89;56
38;38;2018-03-02 10:58:58.110;2018-03-02 12:29:39.547;91;34;89;55
38;38;2018-03-04 23:30:13.230;2018-03-05 01:39:28.707;129;34;89;55
38;38;2018-03-04 23:30:19.787;2018-03-05 01:39:28.707;129;34;89;55
38;38;2018-03-08 11:16:48.910;2018-03-08 12:42:04.977;86;33;89;56
38;38;2018-04-04 09:00:39.120;2018-04-04 10:24:34.560;84;34;89;55
38;38;2018-04-06 12:34:22.093;2018-04-06 14:27:48.873;113;34;89;55
38;38;2018-04-08 22:55:35.453;2018-04-09 03:23:49.910;268;32;89;57
38;38;2018-04-11 11:00:10.110;2018-04-11 11:17:05.560;17;33;37;4
38;38;2018-04-11 11:19:06.710;2018-04-11 12:31:44.250;72;37;86;49
37;37;2017-10-02 17:38:48.397;2017-10-04 12:33:17.463;2575;33;65;32
37;37;2017-10-02 17:48:25.757;2017-10-04 12:33:17.463;2565;33;65;32
37;37;2017-10-02 17:58:21.897;2017-10-04 12:33:17.463;2555;33;65;32
37;37;2017-10-02 18:53:11.627;2017-10-04 12:33:17.463;2500;33;65;32
38;38;2017-11-16 06:21:25.183;2017-11-16 07:29:38.790;68;33;89;56
38;38;2017-11-16 21:38:25.160;2017-11-16 22:45:53.130;67;34;89;55
38;38;2017-11-20 11:05:27.543;2017-11-20 12:08:30.833;63;34;81;47
38;38;2017-11-20 12:11:21.940;2017-11-20 12:35:34.563;24;81;88;7
38;38;2017-11-20 13:18:23.490;2017-11-21 06:29:57.203;1031;86;89;3
38;38;2017-11-22 16:45:21.980;2017-11-23 13:41:06.333;1256;87;89;2
38;38;2017-11-24 07:27:30.483;2017-11-24 08:44:21.430;77;33;89;56
38;38;2017-11-24 07:34:16.510;2017-11-24 08:44:21.430;70;33;89;56
38;38;2017-11-27 13:26:00.943;2017-11-27 15:24:50.730;118;34;89;55
38;38;2017-11-27 13:33:48.457;2017-11-27 15:24:50.730;111;34;89;55
38;38;2017-11-29 15:15:50.250;2017-11-29 16:54:42.800;99;34;80;46
38;38;2017-11-30 17:27:20.550;2017-12-01 13:12:49.400;1185;31;89;58
38;38;2017-12-05 18:12:59.047;2017-12-05 20:13:25.037;121;33;89;56
38;38;2017-12-08 03:44:41.520;2017-12-09 22:40:20.753;2576;62;100;38
38;38;2017-12-11 14:32:11.213;2017-12-11 16:23:21.190;111;34;89;55
38;38;2017-12-20 03:14:56.927;2017-12-20 05:25:08.487;131;34;89;55
38;38;2017-12-26 08:34:08.767;2017-12-26 10:48:47.020;134;34;81;47
38;38;2017-12-26 08:59:13.540;2017-12-26 10:48:47.020;109;34;81;47
38;38;2017-12-26 09:06:17.930;2017-12-26 10:48:47.020;102;34;81;47
38;38;2018-01-04 07:23:40.633;2018-01-04 09:13:36.913;110;33;89;56
38;38;2018-01-05 08:14:56.490;2018-01-05 10:35:41.493;141;33;89;56
38;38;2018-01-05 08:34:32.227;2018-01-05 10:35:41.493;121;33;89;56
38;38;2018-01-16 08:24:17.720;2018-01-16 15:04:45.657;400;34;89;55
38;38;2018-01-16 08:28:30.120;2018-01-16 15:04:45.657;396;34;89;55
38;38;2018-01-16 08:31:12.927;2018-01-16 15:04:45.657;393;34;89;55
38;38;2018-01-16 12:34:32.943;2018-01-16 15:04:45.657;150;34;89;55
38;38;2018-01-17 15:45:50.483;2018-01-17 17:31:48.287;106;34;89;55
38;38;2018-01-19 17:32:10.637;2018-01-19 19:34:40.977;122;33;89;56
38;38;2018-01-19 17:36:55.860;2018-01-19 19:34:40.977;118;33;89;56
38;38;2018-01-22 23:12:52.543;2018-01-23 04:14:24.613;302;34;100;66
38;38;2018-02-05 06:12:21.580;2018-02-05 12:16:40.507;364;16;100;84
38;38;2018-02-05 06:24:05.223;2018-02-05 12:16:40.507;352;16;100;84
38;38;2018-02-06 08:12:38.177;2018-02-06 10:06:35.743;114;33;83;50
38;38;2018-02-06 23:20:02.360;2018-02-07 01:11:48.553;111;33;89;56
38;38;2018-02-08 11:47:22.543;2018-02-08 13:05:16.687;78;39;79;40
38;38;2018-02-08 15:48:58.910;2018-02-09 09:22:33.617;1054;78;89;11
38;38;2018-02-09 06:57:14.453;2018-02-09 09:22:33.617;145;34;89;55
38;38;2018-02-11 22:43:36.663;2018-02-12 03:30:56.627;287;31;93;62
38;38;2018-02-12 20:44:59.560;2018-02-12 22:04:35.527;80;34;89;55
38;38;2018-02-13 15:15:24.043;2018-02-13 16:38:14.017;83;34;89;55
38;38;2018-02-14 11:54:48.493;2018-02-14 13:17:51.417;83;33;84;51
38;38;2018-03-06 21:51:11.593;2018-03-06 23:10:34.943;79;33;89;56
38;38;2018-03-07 15:01:06.167;2018-03-07 16:22:17.943;81;34;89;55
38;38;2018-03-12 13:42:02.803;2018-03-12 15:40:20.650;118;34;89;55
38;38;2018-04-03 10:31:01.680;2018-04-03 11:50:12.297;79;34;89;55
38;38;2018-04-09 20:36:14.883;2018-04-09 21:57:34.843;81;33;89;56
38;38;2018-04-10 13:32:57.250;2018-04-10 14:56:22.010;84;34;89;55
38;38;2018-04-16 09:02:52.367;2018-04-16 11:57:20.753;175;34;84;50
38;38;2018-01-28 00:35:18.830;2018-01-29 06:21:06.210;1786;45;75;30
38;38;2018-01-29 23:19:04.540;2018-01-30 04:32:55.273;313;34;100;66
38;38;2018-02-16 01:45:26.210;2018-02-16 03:39:18.880;114;34;89;55
38;38;2018-02-19 20:56:00.160;2018-02-19 22:17:02.400;81;34;89;55
38;38;2018-02-27 13:34:23.103;2018-02-27 14:50:56.230;76;33;89;56
38;38;2018-02-26 16:36:14.560;2018-02-26 18:51:47.980;135;34;89;55
38;38;2018-03-20 09:01:41.423;2018-03-20 10:22:43.713;81;33;89;56
38;38;2018-03-23 07:49:05.920;2018-03-23 09:30:04.920;101;34;88;54
38;38;2018-04-27 16:09:48.943;2018-04-27 16:51:27.663;42;99;100;1
38;38;2018-04-30 07:24:57.193;2018-04-30 13:03:09.080;339;34;98;64
38;38;2018-04-30 08:55:52.820;2018-04-30 13:03:09.080;248;34;98;64
38;38;2018-05-01 23:45:20.163;2018-05-02 01:10:57.017;85;34;89;55
38;38;2018-05-21 20:42:25.897;2018-05-21 22:06:06.183;84;34;89;55
38;38;2018-05-25 08:49:07.007;2018-05-25 10:46:44.937;117;33;89;56
38;38;2018-05-03 22:09:33.517;2018-05-03 23:52:45.677;103;34;89;55
38;38;2018-05-07 07:50:04.557;2018-05-07 09:08:19.393;78;34;89;55
38;38;2018-05-28 01:47:47.410;2018-05-28 04:35:11.770;168;32;89;57
38;38;2018-05-30 11:34:40.037;2018-05-30 13:39:03.850;125;37;89;52
38;38;2018-05-30 11:55:42.387;2018-05-30 13:39:03.850;104;34;89;55
38;38;2018-05-31 09:52:31.657;2018-05-31 11:21:08.850;89;34;89;55
38;38;2018-06-04 10:19:22.880;2018-06-04 12:40:16.050;141;34;89;55
38;38;2018-06-04 10:28:21.737;2018-06-04 12:40:16.050;132;34;89;55
38;38;2018-06-04 10:31:27.440;2018-06-04 12:40:16.050;129;34;89;55
38;38;2018-06-28 07:07:26.580;2018-06-28 11:12:28.560;245;33;89;56
38;38;2018-06-28 09:15:21.147;2018-06-28 11:12:28.560;117;33;89;56
38;38;2018-07-16 00:10:08.270;2018-07-16 08:05:07.507;475;30;89;59
38;38;2018-07-16 06:31:45.540;2018-07-16 08:05:07.507;94;25;89;64
38;38;2018-07-16 20:08:16.520;2018-07-16 22:22:20.640;134;34;89;55
38;38;2018-07-16 20:18:06.770;2018-07-16 22:22:20.640;124;34;89;55
38;38;2018-07-16 20:19:12.717;2018-07-16 22:22:20.640;123;34;89;55
38;38;2018-07-31 11:27:42.487;2018-07-31 13:01:15.113;94;34;89;55
38;38;2018-07-31 11:34:44.100;2018-07-31 13:01:15.113;87;34;89;55
38;38;2018-08-02 21:31:24.510;2018-08-02 22:15:54.770;44;33;43;10
38;38;2018-08-06 04:58:45.050;2018-08-06 06:16:44.700;78;33;89;56
38;38;2018-08-06 20:18:21.907;2018-08-06 21:41:06.570;83;33;89;56
38;38;2018-08-07 10:21:59.283;2018-08-07 12:17:03.113;116;34;82;48
38;38;2018-06-07 16:16:47.293;2018-06-07 17:16:52.083;60;46;89;43
38;38;2018-07-03 09:01:40.267;2018-07-03 10:23:24.583;82;34;89;55
38;38;2018-07-05 04:11:50.450;2018-07-05 05:43:40.230;92;32;89;57
38;38;2018-07-22 23:15:09.040;2018-07-24 09:39:00.157;2064;29;68;39
38;38;2018-07-25 21:01:38.383;2018-07-25 22:24:12.310;83;34;89;55
38;38;2018-08-08 17:27:13.750;2018-08-08 19:29:26.797;122;33;89;56
38;38;2018-08-13 07:49:03.560;2018-08-13 16:27:29.600;518;33;89;56
38;38;2018-08-13 13:58:29.437;2018-08-13 16:27:29.600;149;34;89;55
38;38;2018-08-13 14:50:28.527;2018-08-13 16:27:29.600;97;34;89;55
38;38;2018-08-14 09:22:51.657;2018-08-14 11:12:46.157;110;34;89;55
38;38;2018-08-30 13:30:47.373;2018-08-30 14:57:17.617;87;34;89;55
38;38;2018-08-31 06:30:22.173;2018-08-31 07:56:09.533;86;34;89;55
38;38;2018-09-05 11:07:21.340;2018-09-05 13:22:03.590;135;33;89;56
38;38;2018-08-21 06:18:57.540;2018-08-21 07:51:07.130;93;32;89;57
38;38;2018-08-21 20:12:22.763;2018-08-21 21:44:19.900;92;34;89;55
38;38;2018-08-21 20:14:27.200;2018-08-21 21:44:19.900;90;34;89;55
38;38;2018-08-24 21:25:06.083;2018-08-24 23:19:23.603;114;33;89;56
38;38;2018-09-07 00:29:38.340;2018-09-07 16:48:34.427;979;34;93;59
38;38;2018-09-07 15:11:32.453;2018-09-07 16:48:34.427;97;33;93;60
38;38;2018-09-07 08:22:38.530;2018-09-07 16:48:34.427;506;31;93;62
38;38;2018-09-09 22:08:02.780;2018-09-10 10:31:47.450;743;31;99;68
38;38;2018-09-10 06:40:21.180;2018-09-10 10:31:47.450;231;34;99;65
38;38;2018-09-12 02:35:20.453;2018-09-12 07:28:27.300;293;32;90;58
38;38;2018-09-12 05:53:32.740;2018-09-12 07:28:27.300;95;29;90;61
38;38;2018-09-13 21:06:37.437;2018-09-13 22:13:00.690;67;34;69;35
38;38;2018-09-18 15:15:14.540;2018-09-18 17:12:13.960;117;93;99;6
38;38;2018-09-19 10:55:55.537;2018-09-19 12:31:30.500;96;34;89;55
38;38;2018-09-20 06:27:03.160;2018-09-20 07:58:33.757;91;34;89;55
38;38;2018-09-21 12:43:54.707;2018-09-21 14:22:23.920;99;34;89;55
38;38;2018-09-26 03:16:12.630;2018-09-28 02:42:21.320;2846;34;100;66
38;38;2018-09-26 20:00:31.580;2018-09-28 02:42:21.320;1842;33;100;67
38;38;2018-09-26 20:08:01.457;2018-09-28 02:42:21.320;1834;32;100;68
38;38;2018-09-26 20:09:39.057;2018-09-28 02:42:21.320;1833;32;100;68
38;38;2018-09-26 20:16:58.440;2018-09-28 02:42:21.320;1826;31;100;69
39;39;2018-09-26 15:11:09.773;2018-09-26 20:55:05.317;344;33;100;67
39;39;2018-09-27 17:51:08.507;2018-09-27 19:11:21.830;80;34;89;55
39;39;2018-09-25 15:58:53.777;2018-09-25 16:58:55.690;60;34;43;9
39;39;2018-09-25 16:18:50.350;2018-09-25 16:58:55.690;40;34;43;9
39;39;2018-09-19 05:33:46.810;2018-09-19 06:51:14.150;78;34;89;55
38;38;2018-02-28 20:20:52.067;2018-02-28 21:46:12.807;86;34;89;55
38;38;2018-03-04 23:28:17.670;2018-03-05 01:39:28.707;131;34;89;55
38;38;2018-03-05 18:36:57.133;2018-03-05 21:09:00.577;153;34;89;55
38;38;2018-04-02 10:39:38.760;2018-04-02 15:25:08.057;286;34;100;66
38;38;2018-04-05 00:35:39.850;2018-04-05 02:08:15.603;93;34;89;55
38;38;2018-04-05 16:47:39.223;2018-04-05 18:25:46.703;98;34;89;55
38;38;2018-04-13 06:06:22.550;2018-04-13 08:10:24.673;124;34;89;55
38;38;2018-05-03 07:31:05.140;2018-05-03 09:06:39.937;95;34;89;55
38;38;2018-02-01 15:29:54.320;2018-02-01 17:38:08.037;129;34;89;55
38;38;2018-02-19 20:57:05.690;2018-02-19 22:17:02.400;80;34;89;55
38;38;2018-02-21 11:10:24.187;2018-02-21 12:38:14.370;88;34;89;55
38;38;2018-03-16 07:10:40.403;2018-03-16 09:30:49.527;140;31;85;54
38;38;2018-03-19 12:46:21.730;2018-03-19 14:02:10.717;76;34;89;55
38;38;2018-03-27 06:06:15.337;2018-03-27 07:32:49.363;86;31;89;58
38;38;2018-04-19 09:45:09.497;2018-04-19 11:25:29.937;100;34;89;55
38;38;2018-04-20 00:36:31.813;2018-04-20 02:12:13.773;96;34;93;59
38;38;2018-04-30 07:22:57.087;2018-04-30 13:03:09.080;341;34;98;64
38;38;2018-04-30 07:26:22.363;2018-04-30 13:03:09.080;337;34;98;64
38;38;2018-05-01 23:34:15.430;2018-05-02 01:10:57.017;96;34;89;55
38;38;2018-05-02 15:11:11.980;2018-05-02 16:39:31.773;88;34;89;55
38;38;2018-05-16 16:16:20.020;2018-05-16 17:44:32.847;88;34;92;58
38;38;2018-05-18 19:43:44.350;2018-05-18 21:05:51.003;82;34;89;55
38;38;2018-06-06 07:52:23.327;2018-06-06 09:59:10.390;127;33;92;59
38;38;2018-05-07 21:31:02.150;2018-05-07 22:52:11.747;81;34;89;55
38;38;2018-05-08 13:30:17.440;2018-05-08 15:00:26.837;90;34;89;55
38;38;2018-05-14 15:45:38.957;2018-05-14 17:55:42.440;130;79;89;10
38;38;2018-06-01 03:31:03.727;2018-06-01 05:22:16.607;111;34;89;55
38;38;2018-06-05 10:26:44.080;2018-06-05 12:50:51.493;144;34;89;55
38;38;2018-06-22 07:17:20.473;2018-06-22 10:59:46.770;222;32;100;68
38;38;2018-06-22 07:26:12.490;2018-06-22 10:59:46.770;213;32;100;68
38;38;2018-06-25 14:51:14.897;2018-06-25 16:14:19.967;83;34;89;55
38;38;2018-06-27 10:56:38.893;2018-06-27 11:39:01.337;43;33;52;19
38;38;2018-06-28 09:16:13.023;2018-06-28 11:12:28.560;116;33;89;56
38;38;2018-07-13 22:52:16.220;2018-07-16 08:05:07.507;3433;33;89;56
38;38;2018-07-16 20:16:41.463;2018-07-16 22:22:20.640;126;34;89;55
38;38;2018-07-18 10:37:41.923;2018-07-18 12:08:10.700;91;32;89;57
38;38;2018-08-01 09:03:27.547;2018-08-01 10:42:42.817;99;34;89;55
38;38;2018-08-02 02:48:23.230;2018-08-02 04:33:59.040;105;34;89;55
38;38;2018-08-07 11:02:59.873;2018-08-07 12:17:03.113;75;34;82;48
38;38;2018-08-16 15:09:40.333;2018-08-16 17:23:46.537;134;33;89;56
38;38;2018-06-07 01:59:06.570;2018-06-07 05:08:04.367;189;33;89;56
38;38;2018-07-10 09:31:57.683;2018-07-10 10:58:34.883;87;33;89;56
38;38;2018-07-26 14:45:43.800;2018-07-26 16:12:23.920;87;34;89;55
38;38;2018-07-27 17:12:51.460;2018-07-27 18:46:58.770;94;34;89;55
38;38;2018-07-29 02:01:41.070;2018-07-29 06:34:48.557;273;51;100;49
38;38;2018-07-30 16:52:36.000;2018-07-30 18:25:38.527;93;34;89;55
38;38;2018-08-08 18:03:02.037;2018-08-08 19:29:26.797;86;33;89;56
38;38;2018-08-10 05:43:11.827;2018-08-10 07:14:57.303;91;33;89;56
38;38;2018-08-13 07:49:56.940;2018-08-13 16:27:29.600;518;33;89;56
38;38;2018-08-13 14:46:30.523;2018-08-13 16:27:29.600;101;34;89;55
38;38;2018-08-28 07:35:19.660;2018-08-28 10:03:25.813;148;33;89;56
38;38;2018-08-28 23:57:47.897;2018-08-29 02:44:15.487;167;34;89;55
38;38;2018-08-29 00:05:19.457;2018-08-29 02:44:15.487;159;34;89;55
38;38;2018-08-29 00:07:01.673;2018-08-29 02:44:15.487;157;34;89;55
38;38;2018-09-03 07:41:51.240;2018-09-03 09:19:24.893;98;31;89;58
38;38;2018-09-03 22:45:40.947;2018-09-04 00:23:34.463;98;32;89;57
38;38;2018-09-05 11:44:20.550;2018-09-05 13:22:03.590;98;34;89;55
38;38;2018-08-17 11:33:46.540;2018-08-17 12:54:20.130;81;33;89;56
38;38;2018-08-21 06:18:25.913;2018-08-21 07:51:07.130;93;32;89;57
38;38;2018-08-22 13:27:56.163;2018-08-22 15:02:21.473;95;33;89;56
38;38;2018-08-24 03:34:53.967;2018-08-24 05:23:50.307;109;33;89;56
38;38;2018-09-12 21:36:22.340;2018-09-13 02:08:12.473;272;34;99;65
38;38;2018-09-12 21:47:08.387;2018-09-13 02:08:12.473;261;34;99;65
38;38;2018-09-12 22:00:21.140;2018-09-13 02:08:12.473;248;34;99;65
38;38;2018-09-13 21:01:51.510;2018-09-13 22:13:00.690;72;34;69;35
38;38;2018-09-13 21:03:56.423;2018-09-13 22:13:00.690;70;34;69;35
38;38;2018-09-15 09:33:18.870;2018-09-15 14:57:18.257;324;32;100;68
38;38;2018-09-18 13:03:10.373;2018-09-18 15:07:38.890;124;34;93;59
38;38;2018-09-19 10:52:50.497;2018-09-19 12:31:30.500;99;34;89;55
38;38;2018-09-19 11:08:58.460;2018-09-19 12:31:30.500;83;34;89;55
38;38;2018-09-19 13:59:50.117;2018-09-20 07:58:33.757;1079;87;89;2
38;38;2018-09-20 20:51:42.263;2018-09-20 22:21:09.447;90;34;89;55
38;38;2018-09-25 06:10:17.140;2018-09-25 07:58:04.187;108;31;96;65
38;38;2018-09-26 20:11:13.590;2018-09-28 02:42:21.320;1831;32;100;68
38;38;2018-09-26 20:11:56.277;2018-09-28 02:42:21.320;1831;32;100;68
39;39;2018-09-28 12:28:54.010;2018-09-28 13:51:46.330;83;34;89;55
39;39;2018-09-23 23:25:34.720;2018-09-24 21:08:42.153;1303;23;99;76
39;39;2018-09-18 12:15:18.287;2018-09-18 13:43:11.250;88;33;89;56
39;39;2018-09-12 12:20:44.403;2018-09-12 13:33:17.343;73;34;89;55
39;39;2018-09-11 03:33:23.047;2018-09-11 05:29:53.570;116;30;89;59
39;39;2018-09-07 12:26:49.310;2018-09-07 14:09:16.103;103;33;89;56
39;39;2018-08-24 07:51:47.503;2018-08-24 11:59:52.990;248;33;89;56
39;39;2018-08-22 21:26:42.767;2018-08-23 13:33:39.243;967;58;89;31
39;39;2018-08-20 01:35:08.340;2018-08-20 03:08:10.280;93;28;89;61
39;39;2018-09-04 12:48:22.723;2018-09-04 15:17:07.430;149;34;89;55
39;39;2018-09-04 12:52:24.200;2018-09-04 15:17:07.430;145;34;89;55
39;39;2018-09-02 22:24:15.397;2018-09-03 10:45:00.307;741;45;64;19
39;39;2018-08-09 06:24:12.070;2018-08-09 08:14:25.740;110;34;89;55
39;39;2018-08-09 06:35:04.020;2018-08-09 08:14:25.740;99;34;89;55
39;39;2018-08-08 09:50:33.493;2018-08-08 11:34:48.423;104;33;89;56
39;39;2018-08-08 09:54:29.403;2018-08-08 11:34:48.423;100;33;89;56
39;39;2018-08-10 16:38:28.920;2018-08-10 18:25:06.263;107;34;89;55
39;39;2018-07-29 22:10:35.130;2018-07-30 20:11:26.517;1321;24;34;10
39;39;2018-07-27 02:16:31.860;2018-07-27 03:39:32.650;83;34;89;55
39;39;2018-07-25 14:30:32.137;2018-07-25 15:57:04.663;87;34;89;55
39;39;2018-07-23 12:50:07.663;2018-07-23 13:22:39.167;32;34;52;18
39;39;2018-07-23 13:23:09.563;2018-07-23 14:11:25.730;48;52;89;37
39;39;2018-07-11 07:16:46.883;2018-07-11 08:43:25.127;87;34;89;55
39;39;2018-07-10 06:59:57.080;2018-07-10 08:30:26.727;91;34;89;55
39;39;2018-07-09 13:39:03.247;2018-07-09 15:12:14.137;93;33;89;56
39;39;2018-07-09 13:47:57.143;2018-07-09 15:12:14.137;85;33;89;56
39;39;2018-07-05 00:17:46.810;2018-07-05 01:38:58.063;81;33;89;56
39;39;2018-07-02 20:58:01.883;2018-07-02 22:22:53.997;84;31;89;58
39;39;2018-06-12 09:17:44.993;2018-06-12 10:47:51.877;90;34;89;55
39;39;2018-06-14 12:35:38.013;2018-06-15 05:19:36.920;1004;34;89;55
39;39;2018-06-15 23:25:11.850;2018-06-16 01:05:25.370;100;33;89;56
39;39;2018-06-08 15:19:14.450;2018-06-08 16:49:01.250;90;32;89;57
39;39;2018-08-16 08:25:37.573;2018-08-16 10:41:26.080;136;34;89;55
39;39;2018-08-02 06:32:02.860;2018-08-02 06:51:08.780;19;77;89;12
39;39;2018-08-01 09:34:13.873;2018-08-01 18:42:07.963;548;34;89;55
39;39;2018-08-01 09:37:48.340;2018-08-01 18:42:07.963;545;34;89;55
39;39;2018-07-18 12:44:08.390;2018-07-18 13:56:54.877;72;34;89;55
39;39;2018-07-12 08:55:24.560;2018-07-12 10:19:58.780;84;34;89;55
39;39;2018-07-16 03:03:49.507;2018-07-16 05:00:51.537;117;30;89;59
39;39;2018-06-27 16:03:18.150;2018-06-27 17:15:57.523;72;34;89;55
39;39;2018-06-26 12:56:29.553;2018-06-26 14:33:29.993;97;34;89;55
39;39;2018-06-25 17:24:18.220;2018-06-25 19:09:36.623;105;33;89;56
39;39;2018-06-20 21:52:40.300;2018-06-20 23:29:23.990;97;34;89;55
39;39;2018-06-21 20:35:14.057;2018-06-21 22:01:21.160;86;34;89;55
39;39;2018-06-05 04:52:37.593;2018-06-05 06:17:23.767;85;33;89;56
39;39;2018-06-04 08:00:48.183;2018-06-04 09:21:44.520;81;34;89;55
39;39;2018-05-30 09:12:15.650;2018-05-30 10:33:43.660;81;33;89;56
39;39;2018-05-31 21:35:37.750;2018-05-31 22:57:02.650;82;34;89;55
39;39;2018-05-29 19:44:18.020;2018-05-29 20:42:00.750;58;34;75;41
39;39;2018-05-29 05:25:57.940;2018-05-29 06:46:41.953;81;33;89;56
39;39;2018-05-14 13:29:23.590;2018-05-14 14:08:37.550;39;34;60;26
39;39;2018-05-10 06:54:17.963;2018-05-10 08:25:54.183;91;33;89;56
38;38;2018-03-09 03:48:58.400;2018-03-09 05:18:34.257;90;34;89;55
38;38;2018-03-09 17:32:57.770;2018-03-09 19:08:04.407;96;34;89;55
38;38;2018-03-13 09:17:34.037;2018-03-13 11:20:24.527;123;33;89;56
38;38;2018-04-16 11:58:41.653;2018-04-16 12:09:40.003;11;84;85;1
38;38;2018-01-29 04:46:51.347;2018-01-29 06:21:06.210;95;32;75;43
38;38;2018-01-31 20:10:42.103;2018-01-31 22:00:20.197;110;33;89;56
38;38;2018-02-15 11:11:18.763;2018-02-15 12:55:39.960;104;34;89;55
38;38;2018-02-20 17:44:50.620;2018-02-20 19:09:15.580;85;32;89;57
38;38;2018-02-21 11:13:47.103;2018-02-21 12:38:14.370;85;34;89;55
38;38;2018-02-22 09:25:16.013;2018-02-22 09:26:28.687;1;88;89;1
38;38;2018-02-27 13:24:39.500;2018-02-27 14:50:56.230;86;33;89;56
38;38;2018-03-14 07:46:05.537;2018-03-14 10:13:47.213;147;33;89;56
38;38;2018-03-21 04:06:11.143;2018-03-21 05:30:02.090;84;33;89;56
38;38;2018-03-21 18:39:20.953;2018-03-21 20:07:44.677;88;34;89;55
38;38;2018-03-31 08:23:32.180;2018-03-31 11:21:20.523;178;33;89;56
38;38;2018-04-17 23:21:11.933;2018-04-18 00:45:37.577;84;33;89;56
38;38;2018-04-20 00:22:10.963;2018-04-20 02:12:13.773;110;34;93;59
38;38;2018-04-27 12:12:04.687;2018-04-27 16:06:23.657;234;34;99;65
38;38;2018-05-18 10:25:06.590;2018-05-18 11:05:12.420;40;34;60;26
38;38;2018-05-22 15:38:40.080;2018-05-22 17:08:20.040;90;33;89;56
38;38;2018-05-23 09:55:57.480;2018-05-23 13:17:37.510;202;34;89;55
38;38;2018-05-24 10:52:27.793;2018-05-24 12:39:15.317;107;33;89;56
38;38;2018-05-14 14:20:40.507;2018-05-14 15:17:46.153;57;34;69;35
38;38;2018-05-14 15:18:13.327;2018-05-14 15:40:32.790;22;69;79;10
38;38;2018-05-14 15:41:10.430;2018-05-14 15:42:22.040;1;79;80;1
38;38;2018-05-30 12:16:09.300;2018-05-30 13:39:03.850;83;34;89;55
38;38;2018-06-01 03:39:35.460;2018-06-01 05:22:16.607;103;34;89;55
38;38;2018-06-21 12:11:03.020;2018-06-21 13:08:07.283;57;34;73;39
38;38;2018-06-25 14:52:55.833;2018-06-25 16:14:19.967;82;34;89;55
38;38;2018-06-26 09:32:07.220;2018-06-26 11:03:54.807;91;33;89;56
38;38;2018-06-27 11:39:29.907;2018-06-27 12:43:17.767;64;52;89;37
38;38;2018-07-12 15:41:43.110;2018-07-12 16:56:57.650;75;33;89;56
38;38;2018-07-16 00:05:16.277;2018-07-16 08:05:07.507;480;31;89;58
38;38;2018-07-16 01:45:07.207;2018-07-16 08:05:07.507;380;30;89;59
38;38;2018-07-17 12:15:29.220;2018-07-17 13:46:06.210;91;34;89;55
38;38;2018-07-18 10:34:56.180;2018-07-18 12:08:10.700;94;32;89;57
38;38;2018-07-20 17:41:46.657;2018-07-20 19:35:15.900;114;33;89;56
38;38;2018-07-20 17:49:27.330;2018-07-20 19:35:15.900;106;33;89;56
38;38;2018-07-20 17:55:56.707;2018-07-20 19:35:15.900;100;33;89;56
38;38;2018-08-03 07:18:28.183;2018-08-03 08:10:52.880;52;41;59;18
38;38;2018-08-03 08:13:13.077;2018-08-03 09:02:11.160;49;58;91;33
38;38;2018-06-07 03:01:58.537;2018-06-07 05:08:04.367;127;33;89;56
38;38;2018-06-07 03:48:14.813;2018-06-07 05:08:04.367;80;33;89;56
38;38;2018-06-07 07:13:36.400;2018-06-07 07:17:23.633;4;86;89;3
38;38;2018-07-02 16:01:05.953;2018-07-02 17:23:21.887;82;33;89;56
38;38;2018-07-05 19:55:08.400;2018-07-05 21:10:31.630;75;33;89;56
38;38;2018-07-06 12:34:03.813;2018-07-06 13:07:59.010;33;34;46;12
38;38;2018-07-06 12:40:20.600;2018-07-06 13:07:59.010;27;34;46;12
38;38;2018-07-06 13:08:02.537;2018-07-06 14:05:49.880;57;46;89;43
38;38;2018-07-07 01:23:58.990;2018-07-07 01:44:38.187;21;77;89;12
38;38;2018-07-11 06:17:37.513;2018-07-11 07:43:32.857;86;33;89;56
38;38;2018-07-24 20:15:54.350;2018-07-25 01:34:37.360;319;34;100;66
38;38;2018-08-08 02:42:35.957;2018-08-08 04:06:13.847;84;33;89;56
38;38;2018-08-09 10:43:42.540;2018-08-09 12:17:36.897;94;34;89;55
38;38;2018-08-29 00:06:19.750;2018-08-29 02:44:15.487;158;34;89;55
38;38;2018-08-29 21:19:37.060;2018-08-29 22:48:21.003;89;32;89;57
38;38;2018-09-03 07:43:48.710;2018-09-03 09:19:24.893;96;31;89;58
38;38;2018-09-04 16:17:21.603;2018-09-05 13:22:03.590;1265;34;89;55
38;38;2018-09-05 10:58:06.133;2018-09-05 13:22:03.590;144;33;89;56
38;38;2018-09-05 11:26:41.633;2018-09-05 13:22:03.590;116;34;89;55
38;38;2018-09-05 11:46:00.020;2018-09-05 13:22:03.590;96;34;89;55
38;38;2018-08-23 07:55:09.013;2018-08-23 09:39:06.220;104;33;89;56
38;38;2018-09-07 00:33:15.060;2018-09-07 16:48:34.427;975;33;93;60
38;38;2018-09-09 22:11:39.427;2018-09-10 10:31:47.450;740;31;99;68
38;38;2018-09-11 03:35:09.933;2018-09-12 07:28:27.300;1673;32;90;58
38;38;2018-09-19 10:53:45.797;2018-09-19 12:31:30.500;98;34;89;55
38;38;2018-09-19 11:10:16.650;2018-09-19 12:31:30.500;81;34;89;55
38;38;2018-09-23 23:35:11.957;2018-09-25 06:09:10.463;1834;16;31;15
38;38;2018-09-26 20:02:57.070;2018-09-28 02:42:21.320;1840;33;100;67
38;38;2018-09-26 03:56:35.940;2018-09-28 02:42:21.320;2806;34;100;66
38;38;2018-09-06 09:27:17.547;2018-09-06 11:28:17.643;121;34;89;55
39;39;2018-09-26 15:16:09.113;2018-09-26 20:55:05.317;339;33;100;67
39;39;2018-09-26 15:17:08.580;2018-09-26 20:55:05.317;338;33;100;67
39;39;2018-09-25 16:39:57.293;2018-09-25 16:58:55.690;19;34;43;9
39;39;2018-09-24 18:06:19.913;2018-09-24 21:08:42.153;182;34;99;65
39;39;2018-09-21 20:40:31.473;2018-09-21 22:03:36.020;83;33;89;56
39;39;2018-09-21 02:43:17.337;2018-09-21 04:35:54.490;112;33;89;56
39;39;2018-09-21 02:49:55.117;2018-09-21 04:35:54.490;106;33;89;56
39;39;2018-09-20 10:45:08.380;2018-09-20 12:01:33.530;76;34;89;55
39;39;2018-09-19 17:57:42.570;2018-09-19 19:13:57.147;76;34;89;55
39;39;2018-09-17 13:05:58.173;2018-09-17 14:27:37.183;82;34;89;55
39;39;2018-09-17 13:12:17.100;2018-09-17 14:27:37.183;75;34;89;55
39;39;2018-09-17 10:37:06.167;2018-09-17 14:27:37.183;230;33;89;56
39;39;2018-09-10 07:34:17.933;2018-09-10 08:54:03.227;80;33;93;60
39;39;2018-08-22 20:14:58.840;2018-08-22 21:26:25.167;72;33;58;25
39;39;2018-09-06 20:59:03.497;2018-09-06 22:37:03.903;98;34;89;55
39;39;2018-08-25 14:14:21.053;2018-08-25 15:57:13.057;103;31;89;58
39;39;2018-08-23 11:56:25.477;2018-08-23 13:33:39.243;97;33;89;56
39;39;2018-08-22 04:04:18.773;2018-08-22 05:31:15.067;87;34;89;55
39;39;2018-08-20 01:33:47.473;2018-08-20 03:08:10.280;95;28;89;61
39;39;2018-08-20 18:39:38.073;2018-08-20 20:02:55.220;83;31;89;58
39;39;2018-08-17 02:27:18.780;2018-08-17 04:08:47.947;101;34;92;58
39;39;2018-09-05 06:53:18.387;2018-09-05 08:19:07.243;86;32;89;57
39;39;2018-09-03 10:46:09.150;2018-09-03 14:47:33.890;241;64;100;36
39;39;2018-08-29 08:38:36.170;2018-08-29 10:15:14.220;97;34;97;63
39;39;2018-08-27 16:02:51.037;2018-08-27 16:52:48.697;50;29;48;19
39;39;2018-08-16 06:26:58.363;2018-08-16 06:42:05.693;16;34;36;2
39;39;2018-08-09 23:04:09.220;2018-08-10 00:48:23.827;104;33;89;56
39;39;2018-08-09 06:20:36.713;2018-08-09 08:14:25.740;114;34;89;55
39;39;2018-08-09 06:30:25.857;2018-08-09 08:14:25.740;104;34;89;55
39;39;2018-07-26 09:53:21.620;2018-07-26 11:15:34.757;82;34;89;55
39;39;2018-07-25 14:36:01.147;2018-07-25 15:57:04.663;81;34;89;55
39;39;2018-07-23 15:44:11.620;2018-07-23 15:46:47.510;2;87;89;2
39;39;2018-07-11 07:18:27.950;2018-07-11 08:43:25.127;85;34;89;55
39;39;2018-07-09 13:45:33.723;2018-07-09 15:12:14.137;87;33;89;56
39;39;2018-07-09 13:49:48.030;2018-07-09 15:12:14.137;83;33;89;56
39;39;2018-07-05 14:46:50.403;2018-07-05 16:07:08.573;81;34;89;55
39;39;2018-07-04 08:52:20.797;2018-07-04 10:13:19.113;81;33;89;56
39;39;2018-06-13 02:03:43.447;2018-06-13 02:45:30.550;42;34;60;26
39;39;2018-06-13 17:22:03.747;2018-06-13 18:58:12.137;96;33;89;56
39;39;2018-06-17 22:10:48.957;2018-06-18 03:27:50.270;317;42;100;58
39;39;2018-06-11 09:57:41.657;2018-06-11 11:43:13.287;106;34;89;55
39;39;2018-06-07 07:44:49.957;2018-06-07 09:08:14.283;84;33;89;56
39;39;2018-08-07 02:59:06.013;2018-08-07 04:36:39.487;97;33;89;56
39;39;2018-08-06 07:44:04.097;2018-08-06 09:12:49.620;88;34;89;55
39;39;2018-07-30 20:11:57.203;2018-07-30 21:36:48.153;85;34;90;56
39;39;2018-07-17 03:00:18.953;2018-07-17 04:30:30.360;90;32;92;60
39;39;2018-07-13 03:57:14.840;2018-07-13 05:05:14.130;68;33;79;46
39;39;2018-06-28 08:19:43.057;2018-06-28 09:13:38.390;54;34;74;40
39;39;2018-06-26 12:52:50.133;2018-06-26 14:33:29.993;101;34;89;55
39;39;2018-06-26 12:55:12.650;2018-06-26 14:33:29.993;98;34;89;55
39;39;2018-06-25 14:51:51.287;2018-06-25 19:09:36.623;258;34;89;55
39;39;2018-06-25 17:27:39.493;2018-06-25 19:09:36.623;102;33;89;56
39;39;2018-06-05 03:51:44.990;2018-06-05 06:17:23.767;146;33;89;56
39;39;2018-06-01 14:34:54.587;2018-06-01 15:57:04.523;83;34;89;55
39;39;2018-05-30 09:03:43.433;2018-05-30 10:33:43.660;90;33;89;56
39;39;2018-05-28 07:23:09.213;2018-05-28 08:43:02.210;80;33;89;56
38;38;2018-04-12 11:21:43.903;2018-04-12 13:25:25.837;124;34;89;55
38;38;2018-04-13 20:43:59.530;2018-04-13 22:56:18.697;133;34;89;55
38;38;2018-04-17 04:18:09.113;2018-04-17 09:00:15.370;282;34;92;58
38;38;2018-01-26 15:01:39.517;2018-01-26 16:43:50.010;102;34;89;55
38;38;2018-01-27 18:01:07.540;2018-01-29 06:21:06.210;2180;49;75;26
38;38;2018-01-28 22:09:18.387;2018-01-29 06:21:06.210;492;39;75;36
38;38;2018-01-31 00:08:23.780;2018-01-31 01:58:47.837;110;33;89;56
38;38;2018-02-16 01:41:08.480;2018-02-16 03:39:18.880;118;34;89;55
38;38;2018-02-18 23:38:51.470;2018-02-19 02:11:29.190;153;34;89;55
38;38;2018-02-22 07:56:11.357;2018-02-22 09:25:07.023;89;33;88;55
38;38;2018-02-26 00:20:16.803;2018-02-26 02:21:22.340;121;33;89;56
38;38;2018-02-27 13:33:05.013;2018-02-27 14:50:56.230;77;33;89;56
38;38;2018-02-23 03:31:41.987;2018-02-23 05:12:26.960;101;33;89;56
38;38;2018-03-15 04:08:49.497;2018-03-15 06:45:35.533;157;34;88;54
38;38;2018-03-22 12:36:45.787;2018-03-22 14:11:52.330;95;34;89;55
38;38;2018-03-26 00:56:20.273;2018-03-26 06:03:26.770;307;28;98;70
38;38;2018-03-28 15:11:40.570;2018-03-28 16:49:10.167;98;33;89;56
38;38;2018-04-18 14:41:27.200;2018-04-18 16:06:18.683;85;34;89;55
38;38;2018-04-30 09:17:45.947;2018-04-30 13:03:09.080;226;34;98;64
38;38;2018-04-30 09:20:25.847;2018-04-30 13:03:09.080;223;34;98;64
38;38;2018-05-15 10:47:24.447;2018-05-15 14:36:11.790;229;34;88;54
38;38;2018-05-15 10:49:05.573;2018-05-15 14:36:11.790;227;34;88;54
38;38;2018-05-15 11:17:37.880;2018-05-15 14:36:11.790;199;34;88;54
38;38;2018-05-17 13:42:34.040;2018-05-17 15:00:49.770;78;34;89;55
38;38;2018-05-23 09:46:31.060;2018-05-23 13:17:37.510;211;34;89;55
38;38;2018-05-23 11:41:21.973;2018-05-23 13:17:37.510;96;34;89;55
38;38;2018-05-04 12:38:11.530;2018-05-04 14:24:52.883;106;34;93;59
38;38;2018-05-09 06:46:53.477;2018-05-09 08:11:24.947;85;34;89;55
38;38;2018-05-10 09:03:50.680;2018-05-10 10:38:35.887;95;34;89;55
38;38;2018-05-11 15:17:28.720;2018-05-11 17:02:22.287;105;33;89;56
38;38;2018-05-30 12:13:17.853;2018-05-30 13:39:03.850;86;34;89;55
38;38;2018-06-01 03:47:16.787;2018-06-01 05:22:16.607;95;34;89;55
38;38;2018-06-01 21:41:50.120;2018-06-01 23:13:52.530;92;34;89;55
38;38;2018-06-21 12:05:42.040;2018-06-21 13:08:07.283;63;34;73;39
38;38;2018-06-22 07:28:29.967;2018-06-22 10:59:46.770;211;32;100;68
38;38;2018-06-27 03:26:20.433;2018-06-27 11:39:01.337;493;33;52;19
38;38;2018-06-27 10:59:16.233;2018-06-27 11:39:01.337;40;33;52;19
38;38;2018-07-16 21:00:38.620;2018-07-16 22:22:20.640;82;34;89;55
38;38;2018-07-17 17:42:08.640;2018-07-18 12:08:10.700;1106;84;89;5
38;38;2018-07-20 06:05:53.683;2018-07-20 07:19:48.897;74;29;75;46
38;38;2018-07-31 11:33:00.293;2018-07-31 13:01:15.113;88;34;89;55
38;38;2018-08-07 10:30:49.177;2018-08-07 12:17:03.113;107;34;82;48
38;38;2018-06-07 02:00:02.920;2018-06-07 05:08:04.367;188;33;89;56
38;38;2018-07-04 02:16:13.040;2018-07-04 03:40:35.130;84;34;89;55
38;38;2018-07-09 12:36:55.930;2018-07-09 14:04:21.823;88;34;89;55
38;38;2018-07-11 21:27:34.493;2018-07-11 22:41:44.650;74;34;89;55
38;38;2018-07-24 08:28:41.457;2018-07-24 09:39:00.157;71;28;68;40
38;38;2018-07-24 09:39:30.473;2018-07-25 01:34:37.360;955;68;100;32
38;38;2018-07-26 14:42:21.890;2018-07-26 16:12:23.920;90;34;89;55
38;38;2018-08-13 07:52:12.990;2018-08-13 16:27:29.600;515;33;89;56
38;38;2018-08-13 14:48:26.510;2018-08-13 16:27:29.600;99;34;89;55
38;38;2018-08-16 05:57:23.983;2018-08-16 06:47:08.800;50;34;60;26
38;38;2018-08-27 13:27:30.240;2018-08-27 15:54:25.490;147;33;89;56
38;38;2018-08-30 13:19:19.230;2018-08-30 14:57:17.617;98;34;89;55
38;38;2018-08-30 13:33:24.613;2018-08-30 14:57:17.617;84;34;89;55
38;38;2018-08-20 09:48:25.840;2018-08-20 11:13:02.040;85;33;89;56
38;38;2018-09-12 22:12:31.950;2018-09-13 02:08:12.473;236;34;99;65
38;38;2018-09-15 09:34:12.100;2018-09-15 14:57:18.257;323;32;100;68
38;38;2018-09-17 12:50:19.673;2018-09-17 15:17:39.977;147;34;95;61
38;38;2018-09-20 06:24:35.880;2018-09-20 07:58:33.757;94;34;89;55
38;38;2018-09-20 06:29:21.033;2018-09-20 07:58:33.757;89;34;89;55
38;38;2018-09-20 06:32:09.900;2018-09-20 07:58:33.757;86;34;89;55
38;38;2018-09-29 04:01:56.360;2018-09-29 05:27:26.903;86;33;89;56
38;38;2018-09-23 23:37:07.670;2018-09-25 06:09:10.463;1832;16;31;15
38;38;2018-09-26 20:10:37.003;2018-09-28 02:42:21.320;1832;32;100;68
38;38;2018-09-27 21:29:23.840;2018-09-28 02:42:21.320;313;33;100;67
39;39;2018-09-26 15:11:05.950;2018-09-26 20:55:05.317;344;33;100;67
39;39;2018-09-18 12:23:45.480;2018-09-18 13:43:11.250;80;33;89;56
39;39;2018-09-17 13:08:59.677;2018-09-17 14:27:37.183;79;34;89;55
39;39;2018-09-17 13:13:26.603;2018-09-17 14:27:37.183;74;34;89;55
39;39;2018-08-24 08:24:37.717;2018-08-24 11:59:52.990;215;35;89;54
39;39;2018-08-24 09:55:20.817;2018-08-24 11:59:52.990;124;33;89;56
39;39;2018-08-20 01:32:28.347;2018-08-20 03:08:10.280;96;30;89;59
39;39;2018-09-06 00:06:24.747;2018-09-06 01:31:01.210;85;33;89;56
39;39;2018-09-04 12:43:08.247;2018-09-04 15:17:07.430;154;34;89;55
39;39;2018-09-04 13:32:46.100;2018-09-04 15:17:07.430;105;34;89;55
39;39;2018-09-04 13:34:47.260;2018-09-04 15:17:07.430;103;34;89;55
39;39;2018-09-03 09:21:08.583;2018-09-03 10:45:00.307;84;34;64;30
39;39;2018-09-03 12:34:42.657;2018-09-03 14:47:33.890;133;99;100;1
39;39;2018-09-01 01:34:43.517;2018-09-01 03:04:08.647;90;33;89;56
39;39;2018-08-30 04:39:13.023;2018-08-30 10:21:04.680;342;33;100;67
39;39;2018-08-27 16:13:19.610;2018-08-27 16:52:48.697;39;29;48;19
39;39;2018-08-13 11:10:50.387;2018-08-13 12:32:12.627;82;34;82;48
39;39;2018-08-13 11:15:55.003;2018-08-13 12:32:12.627;77;34;82;48
39;39;2018-08-14 13:03:55.387;2018-08-14 15:00:30.037;117;32;89;57
39;39;2018-08-09 06:27:59.453;2018-08-09 08:14:25.740;107;34;89;55
39;39;2018-08-09 06:32:38.660;2018-08-09 08:14:25.740;102;34;89;55
39;39;2018-07-29 22:11:54.507;2018-07-30 20:11:26.517;1320;24;34;10
39;39;2018-07-25 00:06:48.190;2018-07-25 01:27:50.283;81;34;89;55
39;39;2018-07-19 07:26:31.567;2018-07-23 13:22:39.167;6116;34;52;18
39;39;2018-07-06 09:50:01.643;2018-07-06 11:11:28.283;81;33;89;56
39;39;2018-07-03 14:17:14.930;2018-07-03 15:37:50.580;80;33;89;56
39;39;2018-06-13 02:45:38.900;2018-06-13 03:35:13.317;50;60;89;29
39;39;2018-06-15 22:50:45.043;2018-06-16 01:05:25.370;135;33;89;56
39;39;2018-06-11 09:50:14.530;2018-06-11 11:43:13.287;113;34;89;55
39;39;2018-08-16 06:57:43.683;2018-08-16 10:41:26.080;224;36;89;53
39;39;2018-08-16 08:21:33.610;2018-08-16 10:41:26.080;140;34;89;55
39;39;2018-08-16 08:24:59.593;2018-08-16 10:41:26.080;137;34;89;55
39;39;2018-08-01 17:18:28.953;2018-08-01 18:42:07.963;84;34;89;55
39;39;2018-08-01 17:20:40.970;2018-08-01 18:42:07.963;82;34;89;55
39;39;2018-07-17 19:16:26.627;2018-07-17 20:38:33.857;82;33;89;56
39;39;2018-07-17 19:26:27.970;2018-07-17 20:38:33.857;72;34;89;55
39;39;2018-06-28 08:17:24.287;2018-06-28 09:13:38.390;56;34;74;40
39;39;2018-06-28 08:04:32.193;2018-06-28 09:13:38.390;69;34;74;40
39;39;2018-06-28 08:07:48.847;2018-06-28 09:13:38.390;66;34;74;40
39;39;2018-06-22 17:30:56.820;2018-06-22 19:02:34.970;92;34;89;55
39;39;2018-06-05 21:06:53.093;2018-06-05 22:35:51.797;89;33;89;56
39;39;2018-06-18 20:51:02.363;2018-06-18 22:10:24.620;79;34;89;55
39;39;2018-05-30 09:01:02.657;2018-05-30 10:33:43.660;92;33;89;56
39;39;2018-05-31 06:14:34.483;2018-05-31 07:36:33.403;82;31;89;58
39;39;2018-05-14 14:09:13.727;2018-05-14 14:57:27.313;48;60;88;28
39;39;2018-05-09 06:18:49.647;2018-05-09 07:49:07.453;91;31;89;58
39;39;2018-05-08 08:48:07.590;2018-05-08 10:14:13.800;86;33;89;56
39;39;2018-05-04 04:51:32.650;2018-05-04 06:15:01.163;84;33;89;56
39;39;2018-05-22 17:42:45.263;2018-05-22 18:59:47.643;77;35;89;54
39;39;2018-05-18 17:31:56.570;2018-05-18 18:48:14.407;77;32;89;57
39;39;2018-05-17 06:29:40.270;2018-05-17 07:44:13.423;75;33;89;56
39;39;2018-04-30 16:04:13.357;2018-04-30 17:23:18.240;79;33;89;56
39;39;2018-04-26 12:49:05.650;2018-04-26 14:04:55.673;75;34;89;55
39;39;2018-04-17 14:06:00.870;2018-04-17 16:37:20.840;151;34;89;55
39;39;2018-03-23 08:13:06.720;2018-03-23 10:06:12.793;113;33;89;56
39;39;2018-03-21 05:55:51.087;2018-03-21 07:26:33.237;91;34;89;55
39;39;2018-02-23 04:06:57.570;2018-02-23 05:43:03.177;97;34;89;55
39;39;2018-03-13 16:13:35.150;2018-03-13 17:38:28.570;85;33;89;56
39;39;2018-02-22 07:43:18.393;2018-02-22 09:20:32.693;97;32;89;57
39;39;2018-02-20 11:42:03.060;2018-02-20 13:10:52.080;88;34;89;55
39;39;2018-01-29 06:22:33.423;2018-01-29 11:13:39.640;291;31;100;69
39;39;2018-09-14 13:18:01.310;2018-09-14 14:34:16.743;76;33;89;56
39;39;2018-09-13 04:13:50.963;2018-09-13 05:29:40.910;76;33;89;56
39;39;2018-09-11 04:12:23.017;2018-09-11 05:29:53.570;77;30;89;59
39;39;2018-09-11 16:01:13.977;2018-09-11 19:02:53.907;181;34;89;55
39;39;2018-08-22 04:10:37.413;2018-08-22 05:31:15.067;81;34;89;55
39;39;2018-08-21 10:07:06.313;2018-08-21 11:35:56.180;88;33;89;56
39;39;2018-08-21 10:09:47.050;2018-08-21 11:35:56.180;86;33;89;56
39;39;2018-08-18 09:33:12.130;2018-08-20 03:08:10.280;2495;33;89;56
39;39;2018-09-03 09:46:10.850;2018-09-03 10:45:00.307;59;34;64;30
39;39;2018-08-31 04:20:48.867;2018-08-31 05:43:18.910;83;33;89;56
39;39;2018-08-28 10:17:19.750;2018-08-29 10:15:14.220;1438;34;97;63
39;39;2018-08-29 08:36:07.790;2018-08-29 10:15:14.220;99;34;97;63
39;39;2018-08-08 09:53:24.927;2018-08-08 11:34:48.423;101;33;89;56
39;39;2018-08-08 09:56:12.913;2018-08-08 11:34:48.423;98;33;89;56
39;39;2018-07-29 01:41:27.003;2018-07-30 20:11:26.517;2550;33;34;1
39;39;2018-07-24 08:57:49.987;2018-07-24 10:19:29.260;82;33;89;56
39;39;2018-06-15 03:44:20.450;2018-06-15 05:19:36.920;95;32;89;57
39;39;2018-06-15 22:25:11.767;2018-06-16 01:05:25.370;160;33;89;56
39;39;2018-06-11 10:15:10.810;2018-06-11 11:43:13.287;88;34;89;55
39;39;2018-06-07 07:36:15.247;2018-06-07 09:08:14.283;92;33;89;56
39;39;2018-06-07 07:43:26.737;2018-06-07 09:08:14.283;85;33;89;56
39;39;2018-08-07 16:07:19.470;2018-08-07 16:32:58.243;25;33;45;12
39;39;2018-08-03 15:27:36.983;2018-08-03 16:55:07.253;88;33;89;56
39;39;2018-08-02 21:09:35.863;2018-08-02 22:34:06.367;85;34;89;55
39;39;2018-08-01 17:19:41.983;2018-08-01 18:42:07.963;83;34;89;55
39;39;2018-07-30 21:37:08.617;2018-07-31 01:52:50.877;255;90;100;10
39;39;2018-07-16 03:31:17.260;2018-07-16 05:00:51.537;89;30;89;59
39;39;2018-07-16 03:32:17.403;2018-07-16 05:00:51.537;88;30;89;59
39;39;2018-06-29 09:47:38.267;2018-06-29 11:06:04.850;79;34;89;55
39;39;2018-07-13 06:20:32.917;2018-07-13 06:44:59.237;24;77;89;12
39;39;2018-06-28 08:11:57.807;2018-06-28 09:13:38.390;62;34;74;40
39;39;2018-06-25 17:28:37.867;2018-06-25 19:09:36.623;101;33;89;56
39;39;2018-06-20 08:10:26.530;2018-06-20 09:34:29.100;84;33;89;56
39;39;2018-06-20 22:02:48.483;2018-06-20 23:29:23.990;87;34;89;55
39;39;2018-06-19 12:46:23.107;2018-06-19 14:07:48.093;81;34;89;55
39;39;2018-06-05 21:10:28.897;2018-06-05 22:35:51.797;85;33;89;56
39;39;2018-05-28 07:26:41.180;2018-05-28 08:43:02.210;77;33;89;56
39;39;2018-05-11 16:00:08.763;2018-05-11 17:27:09.860;87;33;89;56
39;39;2018-05-10 19:22:39.460;2018-05-10 20:48:43.400;86;34;89;55
39;39;2018-05-09 06:16:40.213;2018-05-09 07:49:07.453;93;31;89;58
39;39;2018-05-10 07:00:01.593;2018-05-10 08:25:54.183;85;33;89;56
39;39;2018-05-07 09:36:48.027;2018-05-07 10:57:49.093;81;34;89;55
39;39;2018-06-06 12:44:34.147;2018-06-06 14:06:25.703;82;34;88;54
39;39;2018-05-22 02:37:38.903;2018-05-22 03:54:08.960;77;32;89;57
39;39;2018-05-17 18:46:42.297;2018-05-17 20:00:54.690;74;34;89;55
39;39;2018-05-02 14:53:51.693;2018-05-02 16:16:12.560;83;33;89;56
39;39;2018-05-01 23:56:55.953;2018-05-02 01:19:00.570;83;32;89;57
39;39;2018-04-29 22:48:38.977;2018-04-30 00:07:18.057;79;34;89;55
39;39;2018-04-18 23:05:16.817;2018-04-19 00:31:20.873;86;34;92;58
39;39;2018-04-17 14:07:26.990;2018-04-17 16:37:20.840;150;34;89;55
39;39;2018-03-20 11:35:11.350;2018-03-20 13:04:02.637;89;34;89;55
39;39;2018-02-21 05:36:23.140;2018-02-21 07:12:52.590;96;34;89;55
39;39;2018-02-21 05:38:52.353;2018-02-21 07:12:52.590;94;34;89;55
39;39;2018-02-02 23:59:13.210;2018-02-03 01:49:57.420;110;33;89;56
39;39;2018-01-31 20:01:56.393;2018-01-31 21:49:15.593;108;33;89;56
39;39;2018-01-26 16:21:45.360;2018-01-26 18:33:05.400;132;33;89;56
39;39;2018-01-26 16:42:41.397;2018-01-26 18:33:05.400;111;33;89;56
39;39;2018-05-03 10:26:10.097;2018-05-03 11:49:27.607;83;34;89;55
39;39;2018-04-12 17:01:52.577;2018-04-12 19:02:53.630;121;34;89;55
39;39;2018-04-04 09:01:07.360;2018-04-04 11:07:30.860;126;33;89;56
39;39;2018-04-03 10:19:49.487;2018-04-03 12:20:03.903;121;33;89;56
39;39;2018-03-08 11:45:50.450;2018-03-08 13:07:10.730;82;34;89;55
39;39;2018-03-01 10:08:35.237;2018-03-01 11:26:39.353;78;33;89;56
39;39;2018-02-14 10:52:14.053;2018-02-14 12:37:34.810;105;34;89;55
39;39;2018-02-14 11:15:52.497;2018-02-14 12:37:34.810;82;34;89;55
39;39;2018-02-07 17:48:46.583;2018-02-07 19:50:18.360;122;33;89;56
39;39;2018-01-22 05:19:42.080;2018-01-24 00:37:01.740;2598;33;57;24
39;39;2018-01-05 10:03:54.613;2018-01-07 22:18:27.430;3615;34;76;42
39;39;2018-01-03 15:01:25.693;2018-01-03 16:15:54.107;74;64;77;13
39;39;2017-12-29 01:42:57.367;2018-01-02 09:46:51.117;6244;33;77;44
39;39;2017-12-28 06:52:29.503;2017-12-28 10:13:04.473;201;33;79;46
39;39;2017-12-28 06:54:17.170;2017-12-28 10:13:04.473;199;33;79;46
39;39;2017-12-27 13:15:46.573;2017-12-27 20:45:28.053;450;33;79;46
39;39;2017-12-26 19:50:54.590;2017-12-27 01:52:11.703;362;33;99;66
39;39;2017-12-26 19:54:22.243;2017-12-27 01:52:11.703;358;33;99;66
39;39;2017-12-21 15:13:04.780;2017-12-26 09:07:24.167;6834;33;79;46
39;39;2017-12-21 15:14:27.357;2017-12-26 09:07:24.167;6833;33;79;46
39;39;2017-12-21 15:15:39.453;2017-12-26 09:07:24.167;6832;33;79;46
39;39;2017-12-21 15:17:02.230;2017-12-26 09:07:24.167;6830;33;79;46
39;39;2017-12-15 15:29:09.497;2017-12-15 20:41:26.600;312;33;80;47
39;39;2017-12-04 12:47:07.000;2017-12-04 15:13:36.650;146;33;89;56
39;39;2017-12-02 04:45:59.113;2017-12-02 06:41:25.253;116;34;89;55
40;40;2017-10-04 09:30:01.640;2017-10-04 10:18:04.733;48;34;76;42
40;40;2017-10-02 18:20:40.550;2017-10-02 18:52:13.690;32;34;61;27
40;40;2017-11-03 01:46:13.557;2017-11-03 03:03:07.307;77;33;89;56
40;40;2017-10-19 08:03:55.170;2017-10-19 08:10:47.010;7;54;61;7
40;40;2017-11-13 22:31:19.260;2017-11-13 22:46:10.157;15;80;89;9
40;40;2017-11-09 14:49:03.360;2017-11-09 15:59:04.020;70;33;89;56
40;40;2017-11-17 01:49:52.217;2017-11-17 03:00:08.463;71;34;89;55
40;40;2017-11-15 10:45:42.767;2017-11-15 11:52:37.773;67;34;89;55
40;40;2017-10-30 08:34:13.367;2017-10-30 10:00:06.487;86;31;84;53
40;40;2017-10-26 20:12:34.143;2017-10-26 21:24:14.933;72;33;89;56
40;40;2017-10-24 08:39:34.253;2017-10-24 10:33:29.030;114;33;89;56
40;40;2017-10-24 08:52:17.003;2017-10-24 10:33:29.030;101;33;89;56
40;40;2017-10-24 09:27:00.443;2017-10-24 10:33:29.030;66;33;89;56
40;40;2017-10-19 15:14:53.777;2017-10-19 16:23:31.703;69;34;89;55
40;40;2017-10-16 18:06:54.840;2017-10-16 20:13:28.010;127;34;89;55
40;40;2017-10-17 12:05:20.703;2017-10-17 14:56:43.453;171;34;89;55
40;40;2017-10-11 04:07:39.477;2017-10-11 07:30:15.390;203;34;92;58
40;40;2017-12-07 23:56:31.217;2017-12-11 16:11:33.970;5295;84;89;5
40;40;2017-11-29 09:05:51.050;2017-11-29 10:51:59.407;106;33;83;50
40;40;2017-11-27 20:27:04.510;2017-11-27 22:42:57.917;135;34;89;55
40;40;2017-11-27 07:06:04.083;2017-11-27 09:20:47.640;134;33;89;56
40;40;2017-11-27 07:23:15.127;2017-11-27 09:20:47.640;117;33;89;56
40;40;2017-12-13 18:13:20.410;2017-12-13 20:01:09.987;108;33;89;56
40;40;2017-12-26 17:07:57.427;2017-12-26 18:49:01.470;102;34;89;55
40;40;2017-12-28 05:12:14.953;2017-12-28 07:11:07.300;119;31;89;58
40;40;2017-12-29 01:41:13.920;2017-12-29 03:50:02.073;129;34;89;55
40;40;2018-01-06 02:01:30.413;2018-01-06 03:29:32.707;88;76;95;19
40;40;2018-01-08 17:08:33.257;2018-01-08 18:49:08.380;101;34;89;55
40;40;2018-01-09 09:47:10.833;2018-01-09 11:36:18.240;109;33;89;56
40;40;2018-01-10 03:52:33.057;2018-01-10 05:49:18.477;117;34;89;55
40;40;2018-01-10 03:54:26.877;2018-01-10 05:49:18.477;115;34;89;55
40;40;2018-01-11 11:33:03.383;2018-01-11 13:43:37.163;130;33;93;60
40;40;2018-01-12 09:45:58.947;2018-01-12 12:02:05.537;137;33;89;56
40;40;2018-01-16 01:05:36.367;2018-01-16 02:56:57.843;111;33;89;56
40;40;2018-01-15 07:29:20.673;2018-01-15 09:12:51.470;103;34;89;55
40;40;2018-01-23 13:25:39.970;2018-01-23 15:15:15.607;110;34;89;55
40;40;2018-01-16 20:06:29.913;2018-01-16 21:56:16.217;110;34;89;55
40;40;2018-01-17 19:09:09.267;2018-01-17 21:04:26.327;115;34;89;55
40;40;2018-01-24 08:50:35.917;2018-01-24 10:43:02.720;113;34;89;55
40;40;2018-01-25 05:15:43.003;2018-01-25 07:35:28.573;140;34;89;55
40;40;2018-01-25 05:26:07.043;2018-01-25 07:35:28.573;129;34;89;55
40;40;2018-02-07 10:22:33.670;2018-02-07 12:12:10.897;110;34;89;55
40;40;2018-02-08 03:37:33.807;2018-02-08 05:30:06.610;113;34;89;55
40;40;2018-02-08 03:39:44.383;2018-02-08 05:30:06.610;111;34;89;55
40;40;2018-02-09 12:00:05.167;2018-02-09 13:32:52.140;92;33;89;56
39;39;2018-05-09 22:18:50.970;2018-05-10 08:25:54.183;607;33;89;56
39;39;2018-05-25 09:27:57.297;2018-05-25 10:44:35.750;77;33;89;56
39;39;2018-05-24 13:37:18.050;2018-05-24 14:55:07.817;78;33;89;56
39;39;2018-05-22 17:42:47.730;2018-05-22 18:59:47.643;77;35;89;54
39;39;2018-05-15 10:24:44.543;2018-05-15 11:55:56.340;91;33;89;56
39;39;2018-05-16 06:27:42.010;2018-05-16 08:00:14.860;93;33;89;56
39;39;2018-04-27 08:30:08.083;2018-04-27 09:47:40.483;77;34;89;55
39;39;2018-04-20 09:53:20.040;2018-04-20 11:09:59.377;76;32;89;57
39;39;2018-04-24 10:15:28.707;2018-04-24 11:31:53.653;76;33;89;56
39;39;2018-04-19 17:55:02.350;2018-04-19 19:09:53.673;74;34;89;55
39;39;2018-03-27 03:55:05.210;2018-03-27 05:34:03.690;99;34;89;55
39;39;2018-03-22 14:33:02.720;2018-03-22 16:06:15.893;93;34;89;55
39;39;2018-03-19 16:54:38.863;2018-03-19 18:23:36.290;89;34;89;55
39;39;2018-03-16 20:10:57.920;2018-03-16 21:38:34.100;88;34;89;55
39;39;2018-02-21 05:34:46.410;2018-02-21 07:12:52.590;98;34;89;55
39;39;2018-02-21 05:41:52.047;2018-02-21 07:12:52.590;91;34;89;55
39;39;2018-02-27 04:50:45.913;2018-02-27 06:36:15.597;106;34;89;55
39;39;2018-02-26 08:16:38.473;2018-02-26 10:05:13.363;109;34;89;55
39;39;2018-02-26 08:23:17.127;2018-02-26 10:05:13.363;102;34;89;55
39;39;2018-02-16 01:57:52.330;2018-02-16 03:23:10.813;86;34;89;55
39;39;2018-02-15 11:04:09.827;2018-02-15 12:41:48.763;97;34;89;55
39;39;2018-02-15 11:18:34.247;2018-02-15 12:41:48.763;83;34;89;55
39;39;2018-01-30 23:13:34.313;2018-01-31 01:04:31.117;111;33;89;56
39;39;2018-01-30 05:42:23.323;2018-01-30 07:29:28.457;107;33;89;56
39;39;2018-01-29 06:17:50.717;2018-01-29 11:13:39.640;296;32;100;68
39;39;2018-05-03 07:35:43.983;2018-05-03 07:51:51.437;16;33;42;9
39;39;2018-04-16 20:15:11.500;2018-04-16 22:29:19.620;134;34;89;55
39;39;2018-04-13 12:45:21.537;2018-04-13 14:51:58.553;126;34;89;55
39;39;2018-04-05 22:10:55.903;2018-04-06 00:27:00.470;137;34;89;55
39;39;2018-04-02 17:37:29.757;2018-04-02 19:37:06.803;120;33;89;56
39;39;2018-03-05 17:01:28.477;2018-03-05 18:22:10.287;81;33;89;56
39;39;2018-03-02 02:32:38.483;2018-03-02 03:59:08.790;87;33;89;56
39;39;2018-02-13 16:22:30.103;2018-02-13 17:41:37.780;79;34;89;55
39;39;2018-02-12 22:42:13.340;2018-02-13 00:37:23.377;115;34;89;55
39;39;2018-02-08 11:59:04.767;2018-02-08 14:00:34.197;121;33;89;56
39;39;2018-02-05 14:43:51.243;2018-02-05 16:32:24.240;109;34;89;55
39;39;2018-01-17 23:30:48.003;2018-01-24 00:37:01.740;8707;32;57;25
39;39;2018-01-17 23:40:40.190;2018-01-24 00:37:01.740;8697;32;57;25
39;39;2018-01-15 09:42:18.247;2018-01-15 11:09:25.527;87;33;72;39
39;39;2018-01-15 09:44:45.763;2018-01-15 11:09:25.527;85;33;72;39
39;39;2018-01-08 15:09:58.897;2018-01-08 20:49:14.893;340;34;76;42
39;39;2017-12-29 01:53:45.347;2018-01-02 09:46:51.117;6233;33;77;44
39;39;2017-12-26 19:52:27.413;2017-12-27 01:52:11.703;360;33;99;66
39;39;2017-12-19 14:03:39.263;2017-12-20 07:01:07.573;1018;34;80;46
39;39;2017-12-18 17:43:37.063;2017-12-19 08:50:54.880;907;34;80;46
39;39;2017-12-18 17:45:32.407;2017-12-19 08:50:54.880;905;33;80;47
39;39;2017-12-15 15:34:45.263;2017-12-15 20:41:26.600;307;33;80;47
40;40;2017-10-03 06:06:04.923;2017-10-03 07:32:49.460;86;33;96;63
40;40;2017-11-07 14:28:30.010;2017-11-07 17:27:31.293;179;34;89;55
40;40;2017-11-06 16:11:28.613;2017-11-06 18:14:11.453;123;34;89;55
40;40;2017-11-06 16:13:27.150;2017-11-06 18:14:11.453;121;34;89;55
40;40;2017-11-14 07:23:52.973;2017-11-14 07:33:22.707;10;83;89;6
40;40;2017-11-13 13:50:46.477;2017-11-13 14:47:16.183;57;34;89;55
40;40;2017-11-14 17:15:23.640;2017-11-14 18:16:16.110;61;33;89;56
40;40;2017-10-31 19:43:10.917;2017-10-31 20:45:30.750;62;34;89;55
40;40;2017-10-26 20:11:12.870;2017-10-26 21:24:14.933;73;33;89;56
40;40;2017-10-24 08:47:20.293;2017-10-24 10:33:29.030;106;33;89;56
40;40;2017-10-24 08:56:10.457;2017-10-24 10:33:29.030;97;33;89;56
40;40;2017-10-24 09:06:42.177;2017-10-24 10:33:29.030;87;33;89;56
40;40;2017-10-16 04:15:34.953;2017-10-16 06:31:56.500;136;16;89;73
40;40;2017-10-06 22:52:15.773;2017-10-07 00:42:42.113;110;31;89;58
40;40;2017-10-06 23:07:03.020;2017-10-07 00:42:42.113;95;31;89;58
40;40;2017-12-04 08:17:34.097;2017-12-04 10:07:46.777;110;34;89;55
40;40;2017-12-04 08:20:08.060;2017-12-04 10:07:46.777;107;34;89;55
40;40;2017-12-01 19:39:19.410;2017-12-01 21:32:31.663;113;34;89;55
40;40;2017-12-02 03:00:57.180;2017-12-02 05:47:52.753;167;78;100;22
40;40;2017-11-30 17:19:55.580;2017-11-30 21:50:52.143;271;33;89;56
40;40;2017-12-05 13:01:28.887;2017-12-05 14:58:43.607;117;30;89;59
40;40;2017-12-05 13:05:01.980;2017-12-05 14:58:43.607;113;30;89;59
40;40;2017-12-07 20:09:37.057;2017-12-07 22:06:14.587;117;33;89;56
40;40;2017-12-11 13:09:07.760;2017-12-11 16:11:33.970;182;34;89;55
40;40;2017-12-08 03:45:48.933;2017-12-11 16:11:33.970;5066;78;89;11
40;40;2017-12-08 03:44:40.957;2017-12-11 16:11:33.970;5067;78;89;11
40;40;2017-11-28 16:39:41.787;2017-11-28 18:37:31.890;118;34;86;52
40;40;2017-11-27 20:45:56.110;2017-11-27 22:42:57.917;117;34;89;55
40;40;2017-11-27 06:28:54.530;2017-11-27 09:20:47.640;172;33;89;56
40;40;2017-11-27 07:02:06.400;2017-11-27 09:20:47.640;138;33;89;56
40;40;2017-11-24 09:44:20.910;2017-11-25 06:56:25.067;1272;87;100;13
40;40;2017-11-25 02:10:57.880;2017-11-25 06:56:25.067;286;44;100;56
40;40;2017-11-29 22:28:09.863;2017-11-30 01:37:31.977;189;33;89;56
40;40;2017-12-12 22:23:36.307;2017-12-13 03:02:33.313;279;34;89;55
40;40;2017-12-21 19:38:00.970;2017-12-21 21:56:57.043;138;34;89;55
40;40;2017-12-25 22:16:49.787;2017-12-26 03:31:47.217;315;28;97;69
40;40;2017-12-27 10:25:12.130;2017-12-27 12:08:13.847;103;34;89;55
40;40;2018-01-03 14:35:32.533;2018-01-03 16:17:00.640;102;33;77;44
40;40;2018-01-03 14:38:14.410;2018-01-03 16:17:00.640;99;33;77;44
40;40;2018-01-04 08:04:06.867;2018-01-04 12:02:11.107;238;33;89;56
40;40;2018-01-11 11:31:38.550;2018-01-11 13:43:37.163;132;33;93;60
40;40;2018-01-12 09:47:22.383;2018-01-12 12:02:05.537;135;33;89;56
40;40;2018-01-18 12:22:45.013;2018-01-18 14:27:51.310;125;34;89;55
40;40;2018-01-21 22:02:45.400;2018-01-22 03:38:17.710;336;27;100;73
40;40;2018-01-21 22:03:32.077;2018-01-22 03:38:17.710;335;26;100;74
40;40;2018-01-19 13:28:52.417;2018-01-19 15:44:38.567;136;34;89;55
40;40;2018-02-07 10:09:10.450;2018-02-07 12:12:10.897;123;34;89;55
40;40;2018-02-07 10:24:13.450;2018-02-07 12:12:10.897;108;34;89;55
40;40;2018-02-09 11:53:35.667;2018-02-09 13:32:52.140;99;33;89;56
40;40;2018-02-11 22:29:19.133;2018-02-12 03:42:50.480;313;14;100;86
40;40;2018-02-13 15:30:14.797;2018-02-13 17:20:19.380;110;34;89;55
40;40;2018-02-13 16:00:10.793;2018-02-13 17:20:19.380;80;34;89;55
40;40;2018-02-14 11:32:49.110;2018-02-14 12:59:23.927;87;34;89;55
40;40;2018-02-28 02:12:58.577;2018-02-28 02:18:46.977;6;85;89;4
40;40;2018-03-01 11:52:41.237;2018-03-01 13:21:27.433;89;33;89;56
40;40;2018-03-01 12:08:33.420;2018-03-01 13:21:27.433;73;33;89;56
40;40;2018-03-02 17:16:54.263;2018-03-02 18:56:57.940;100;35;89;54
40;40;2018-03-05 11:11:54.423;2018-03-05 12:33:20.650;82;34;89;55
40;40;2018-03-06 07:44:19.170;2018-03-06 09:17:05.743;93;34;89;55
40;40;2018-03-11 23:06:49.680;2018-03-12 01:20:29.747;134;33;89;56
40;40;2018-03-12 19:47:07.490;2018-03-12 22:36:45.930;169;34;89;55
40;40;2018-04-04 05:51:08.050;2018-04-04 10:42:25.190;291;34;97;63
40;40;2018-04-05 06:48:48.527;2018-04-05 08:12:46.800;84;32;89;57
40;40;2018-04-05 20:53:30.627;2018-04-05 22:18:37.560;85;33;89;56
40;40;2018-04-06 13:52:41.553;2018-04-06 15:23:11.897;91;34;89;55
40;40;2018-04-10 13:32:28.410;2018-04-10 15:05:25.673;93;34;89;55
40;40;2018-04-11 09:44:05.630;2018-04-11 11:14:54.407;90;33;85;52
40;40;2018-01-30 03:39:28.920;2018-01-30 07:29:16.467;230;34;100;66
40;40;2018-01-31 06:50:05.650;2018-01-31 08:38:59.127;108;34;89;55
40;40;2018-02-01 03:17:09.990;2018-02-01 05:07:34.000;110;33;89;56
40;40;2018-02-15 11:18:27.417;2018-02-15 12:34:16.707;76;34;89;55
40;40;2018-02-15 11:17:41.770;2018-02-15 12:34:16.707;77;34;89;55
40;40;2018-02-17 01:14:26.567;2018-02-17 02:38:31.673;84;34;89;55
40;40;2018-02-19 13:23:55.917;2018-02-19 14:47:37.627;84;33;89;56
40;40;2018-02-19 13:25:43.597;2018-02-19 14:47:37.627;82;33;89;56
40;40;2018-02-26 11:15:46.890;2018-02-26 15:28:40.117;253;34;89;55
40;40;2018-02-27 09:10:47.050;2018-02-27 10:28:13.260;78;33;89;56
40;40;2018-02-23 11:25:40.870;2018-02-23 17:41:08.507;376;34;89;55
40;40;2018-03-16 15:13:51.237;2018-03-16 16:47:09.560;94;33;89;56
40;40;2018-03-21 04:04:29.960;2018-03-21 07:20:15.293;196;33;89;56
39;39;2018-05-03 07:51:56.767;2018-05-03 11:49:27.607;238;42;89;47
39;39;2018-04-16 06:32:53.170;2018-04-16 08:25:20.760;113;33;87;54
39;39;2018-04-11 07:50:37.410;2018-04-11 09:39:05.617;109;34;88;54
39;39;2018-04-09 13:41:10.830;2018-04-09 15:21:42.903;100;34;89;55
39;39;2018-04-10 12:11:40.337;2018-04-10 13:59:18.627;108;33;89;56
39;39;2018-04-06 18:11:45.143;2018-04-06 20:28:02.860;137;34;89;55
39;39;2018-03-09 04:23:11.077;2018-03-09 05:48:23.803;85;34;89;55
39;39;2018-03-07 20:00:48.123;2018-03-07 20:43:31.677;43;33;64;31
39;39;2018-03-03 04:23:10.847;2018-03-03 05:44:12.173;81;32;89;57
39;39;2018-02-28 12:35:16.140;2018-02-28 13:55:18.757;80;33;89;56
39;39;2018-02-27 20:57:05.377;2018-02-28 13:55:18.757;1018;33;89;56
39;39;2018-02-12 23:16:47.270;2018-02-13 00:37:23.377;81;34;89;55
39;39;2018-02-11 22:50:16.100;2018-02-12 03:32:02.513;282;26;99;73
39;39;2018-02-08 11:56:47.627;2018-02-08 14:00:34.197;124;33;89;56
39;39;2018-02-06 11:52:01.687;2018-02-06 22:12:41.510;620;64;89;25
39;39;2018-01-17 23:32:51.030;2018-01-24 00:37:01.740;8705;32;57;25
39;39;2018-01-16 20:26:01.717;2018-01-17 11:42:59.827;916;37;60;23
39;39;2018-01-11 03:36:12.193;2018-01-11 10:18:44.263;402;32;75;43
39;39;2018-01-15 09:43:53.437;2018-01-15 11:09:25.527;86;33;72;39
39;39;2018-01-04 15:40:39.137;2018-01-04 20:22:24.180;282;34;77;43
39;39;2018-01-04 15:42:45.873;2018-01-04 20:22:24.180;280;33;77;44
39;39;2018-01-03 14:13:53.343;2018-01-03 14:56:47.187;43;34;64;30
39;39;2018-01-02 05:42:55.810;2018-01-02 09:46:51.117;244;34;77;43
39;39;2017-12-29 01:44:45.400;2018-01-02 09:46:51.117;6242;33;77;44
39;39;2018-01-02 16:08:15.553;2018-01-03 07:10:33.890;902;33;77;44
39;39;2018-01-02 16:13:15.590;2018-01-03 07:10:33.890;897;33;77;44
39;39;2017-12-20 15:31:01.317;2017-12-21 09:00:40.910;1049;32;79;47
39;39;2017-12-16 20:01:59.017;2017-12-17 22:27:48.683;1586;46;80;34
39;39;2017-12-12 21:15:31.283;2017-12-15 07:38:09.490;3503;34;80;46
39;39;2017-12-04 12:48:24.790;2017-12-04 15:13:36.650;145;33;89;56
39;39;2017-12-02 20:02:32.960;2017-12-03 00:22:06.170;260;72;100;28
40;40;2017-11-05 22:04:56.530;2017-11-05 23:45:56.593;101;31;89;58
40;40;2017-11-09 01:05:22.610;2017-11-09 02:11:43.180;66;33;89;56
40;40;2017-11-13 22:32:55.070;2017-11-13 22:46:10.157;14;80;89;9
40;40;2017-11-14 01:52:10.967;2017-11-14 01:57:23.790;5;85;89;4
40;40;2017-11-14 07:20:41.333;2017-11-14 07:33:22.707;13;83;89;6
40;40;2017-11-21 17:29:55.590;2017-11-21 19:43:25.420;134;34;89;55
40;40;2017-11-21 17:37:04.210;2017-11-21 19:43:25.420;126;34;89;55
40;40;2017-11-20 20:53:28.870;2017-11-20 22:38:26.810;105;33;89;56
40;40;2017-11-13 13:40:11.723;2017-11-13 14:47:16.183;67;34;89;55
40;40;2017-11-20 05:54:29.677;2017-11-20 07:36:20.920;102;28;89;61
40;40;2017-11-15 10:48:55.117;2017-11-15 11:52:37.773;64;34;89;55
40;40;2017-11-14 17:01:26.300;2017-11-14 18:16:16.110;75;33;89;56
40;40;2017-11-16 09:06:15.773;2017-11-16 10:14:03.057;68;34;89;55
40;40;2017-10-30 08:08:57.010;2017-10-30 10:00:06.487;112;31;84;53
40;40;2017-10-24 08:41:11.327;2017-10-24 10:33:29.030;112;33;89;56
40;40;2017-10-24 08:42:46.207;2017-10-24 10:33:29.030;111;33;89;56
40;40;2017-10-24 08:59:03.953;2017-10-24 10:33:29.030;94;33;89;56
40;40;2017-10-23 15:37:33.157;2017-10-23 16:36:16.273;59;36;89;53
40;40;2017-10-22 21:52:47.303;2017-10-23 01:43:36.980;231;37;99;62
40;40;2017-10-18 11:35:05.493;2017-10-18 12:39:40.220;64;33;89;56
40;40;2017-10-16 04:16:47.757;2017-10-16 06:31:56.500;135;15;89;74
40;40;2017-10-10 07:00:21.260;2017-10-10 09:26:39.153;146;34;89;55
40;40;2017-10-09 14:38:21.570;2017-10-09 16:48:00.753;130;34;89;55
40;40;2017-10-05 06:59:45.047;2017-10-05 08:14:33.873;75;33;89;56
40;40;2017-12-11 13:12:13.230;2017-12-11 16:11:33.970;179;34;89;55
40;40;2017-11-27 20:31:35.527;2017-11-27 22:42:57.917;131;34;89;55
40;40;2017-11-27 06:41:45.723;2017-11-27 09:20:47.640;159;33;89;56
40;40;2017-11-24 07:38:24.547;2017-11-24 08:46:16.233;68;34;89;55
40;40;2017-11-29 22:37:06.540;2017-11-30 01:37:31.977;180;33;89;56
40;40;2017-12-12 22:32:34.423;2017-12-13 03:02:33.313;270;34;89;55
40;40;2017-12-15 06:42:33.793;2017-12-15 08:35:42.780;113;33;89;56
40;40;2017-12-23 02:01:34.417;2017-12-26 03:31:47.217;4410;34;97;63
40;40;2017-12-27 10:21:08.683;2017-12-27 12:08:13.847;107;34;89;55
40;40;2017-12-28 05:09:57.797;2017-12-28 07:11:07.300;122;31;89;58
40;40;2017-12-29 00:05:55.903;2017-12-29 03:50:02.073;225;34;89;55
40;40;2017-12-29 00:05:57.290;2017-12-29 03:50:02.073;225;34;89;55
40;40;2018-01-02 09:48:30.097;2018-01-02 11:30:37.920;102;16;61;45
40;40;2018-01-02 20:32:11.793;2018-01-02 22:53:20.410;141;33;89;56
40;40;2018-01-05 09:54:50.387;2018-01-05 14:27:00.063;273;34;91;57
40;40;2018-01-12 10:20:35.150;2018-01-12 12:02:05.537;102;33;89;56
40;40;2018-01-10 17:02:05.337;2018-01-10 19:04:20.120;122;34;89;55
40;40;2018-01-18 12:24:08.667;2018-01-18 14:27:51.310;123;34;89;55
40;40;2018-01-22 21:25:31.130;2018-01-22 23:16:04.603;111;34;89;55
40;40;2018-01-22 21:29:40.730;2018-01-22 23:16:04.603;107;34;89;55
40;40;2018-01-23 12:58:45.713;2018-01-23 15:15:15.607;137;34;89;55
40;40;2018-01-16 20:00:45.927;2018-01-16 21:56:16.217;116;34;89;55
40;40;2018-01-21 22:04:31.300;2018-01-22 03:38:17.710;334;26;100;74
40;40;2018-01-19 13:30:27.813;2018-01-19 15:44:38.567;134;34;89;55
40;40;2018-02-06 14:56:19.890;2018-02-06 16:41:03.100;105;34;89;55
40;40;2018-02-05 14:13:48.723;2018-02-05 17:30:11.237;197;33;89;56
40;40;2018-02-11 22:28:00.353;2018-02-12 03:42:50.480;314;14;100;86
40;40;2018-02-12 20:24:02.963;2018-02-12 21:57:27.547;93;34;89;55
40;40;2018-02-12 20:35:54.817;2018-02-12 21:57:27.547;82;34;89;55
40;40;2018-02-12 20:39:35.470;2018-02-12 21:57:27.547;78;34;89;55
40;40;2018-02-27 22:08:10.847;2018-02-27 23:28:31.033;80;34;89;55
40;40;2018-02-28 02:02:01.800;2018-02-28 02:18:46.977;16;86;89;3
40;40;2018-02-28 18:07:55.647;2018-02-28 19:33:30.573;86;34;89;55
40;40;2018-02-28 18:21:31.533;2018-02-28 19:33:30.573;72;34;89;55
40;40;2018-03-02 17:25:38.110;2018-03-02 18:56:57.940;91;32;89;57
40;40;2018-03-05 11:10:48.897;2018-03-05 12:33:20.650;83;34;89;55
40;40;2018-03-07 01:30:35.150;2018-03-07 03:02:10.967;92;33;89;56
40;40;2018-04-09 21:31:11.623;2018-04-09 22:59:01.963;88;34;89;55
40;40;2018-04-12 19:33:22.330;2018-04-12 22:02:25.397;149;34;89;55
40;40;2018-04-13 12:51:41.830;2018-04-13 15:56:40.260;185;33;89;56
40;40;2018-01-26 03:38:03.743;2018-01-26 06:19:43.590;161;34;89;55
40;40;2018-01-31 06:52:02.487;2018-01-31 08:38:59.127;106;34;89;55
40;40;2018-02-01 20:26:11.743;2018-02-01 22:25:28.960;119;33;89;56
40;40;2018-02-03 02:27:41.023;2018-02-03 04:52:27.790;145;34;89;55
40;40;2018-02-01 03:13:49.730;2018-02-01 05:07:34.000;114;33;89;56
40;40;2018-02-20 07:09:05.727;2018-02-20 08:37:28.370;88;34;89;55
40;40;2018-02-21 03:21:13.907;2018-02-21 04:57:32.790;96;33;89;56
40;40;2018-02-26 11:12:44.347;2018-02-26 15:28:40.117;256;34;89;55
40;40;2018-03-13 21:02:33.540;2018-03-14 00:54:59.597;232;34;89;55
40;40;2018-03-15 23:16:57.590;2018-03-16 00:39:57.210;83;34;89;55
40;40;2018-03-27 19:23:53.060;2018-03-27 20:52:00.483;89;31;89;58
40;40;2018-04-18 09:01:34.103;2018-04-18 10:12:20.930;71;33;73;40
40;40;2018-04-26 11:21:05.257;2018-04-26 12:41:38.570;80;34;89;55
40;40;2018-04-25 09:23:39.870;2018-04-25 10:18:39.857;55;27;48;21
40;40;2018-04-20 12:08:31.173;2018-04-20 15:30:30.377;202;34;89;55
40;40;2018-04-27 22:51:10.540;2018-04-28 00:22:24.400;91;34;89;55
40;40;2018-04-30 11:15:45.933;2018-04-30 12:39:34.047;84;33;89;56
40;40;2018-05-15 19:20:40.367;2018-05-15 21:24:44.103;124;33;89;56
40;40;2018-05-21 20:50:07.670;2018-05-21 22:12:38.853;82;34;89;55
40;40;2018-05-21 06:39:21.900;2018-05-21 08:00:37.980;81;32;89;57
40;40;2018-05-12 10:01:28.107;2018-05-12 14:45:37.517;284;61;100;39
40;40;2018-05-28 10:00:51.363;2018-05-28 11:52:06.450;112;33;89;56
32;32;2017-10-28 13:02:11.053;2017-10-30 10:02:08.873;2700;48;85;37
32;32;2017-10-30 08:05:56.230;2017-10-30 10:02:08.873;117;16;85;69
32;32;2017-10-29 22:12:13.060;2017-10-30 10:02:08.873;710;26;85;59
32;32;2017-10-29 22:13:38.193;2017-10-30 10:02:08.873;709;25;85;60
32;32;2017-10-30 20:56:44.583;2017-10-30 22:47:53.827;111;33;91;58
32;32;2017-10-30 20:59:58.320;2017-10-30 22:47:53.827;108;33;91;58
32;32;2017-10-30 21:01:07.360;2017-10-30 22:47:53.827;106;33;91;58
32;32;2017-10-30 21:02:45.540;2017-10-30 22:47:53.827;105;33;91;58
32;32;2017-10-30 21:21:35.060;2017-10-30 22:47:53.827;86;33;91;58
32;32;2017-11-02 12:08:13.473;2017-11-02 13:16:43.697;68;34;89;55
39;39;2018-05-09 06:17:44.173;2018-05-09 07:49:07.453;92;31;89;58
39;39;2018-05-09 06:21:35.983;2018-05-09 07:49:07.453;88;31;89;58
39;39;2018-05-04 20:58:32.910;2018-05-04 22:21:52.597;83;34;89;55
39;39;2018-05-23 13:54:33.290;2018-05-23 15:13:11.337;79;34;89;55
39;39;2018-05-22 17:44:17.740;2018-05-22 18:59:47.643;75;35;89;54
39;39;2018-05-21 12:29:48.400;2018-05-21 13:41:54.120;72;34;89;55
39;39;2018-04-24 21:46:24.653;2018-04-24 23:03:26.170;77;34;89;55
39;39;2018-04-01 22:16:33.380;2018-04-02 00:11:36.633;115;33;89;56
39;39;2018-03-27 20:36:35.677;2018-03-27 22:18:04.227;102;34;89;55
39;39;2018-03-26 09:29:05.203;2018-03-26 11:05:45.923;96;34;89;55
39;39;2018-03-21 22:50:13.353;2018-03-22 00:23:16.620;93;34;89;55
39;39;2018-03-16 03:27:20.590;2018-03-16 04:54:35.833;87;33;89;56
39;39;2018-03-14 10:55:55.220;2018-03-14 12:19:38.630;84;34;89;55
39;39;2018-03-15 10:20:32.337;2018-03-15 11:44:56.953;84;34;89;55
39;39;2018-02-23 04:02:55.260;2018-02-23 05:43:03.177;101;34;89;55
39;39;2018-02-27 04:47:52.340;2018-02-27 06:36:15.597;109;34;89;55
39;39;2018-02-19 18:36:20.337;2018-02-19 20:04:25.660;88;34;89;55
39;39;2018-02-18 23:06:27.687;2018-02-19 00:33:22.700;87;33;89;56
39;39;2018-02-15 11:19:17.247;2018-02-15 12:41:48.763;82;34;89;55
39;39;2018-02-15 11:17:52.507;2018-02-15 12:41:48.763;84;34;89;55
39;39;2018-02-01 16:32:51.723;2018-02-01 18:20:21.710;108;34;89;55
39;39;2018-01-25 12:39:19.403;2018-01-25 16:09:08.003;210;61;100;39
39;39;2018-04-12 00:10:51.083;2018-04-12 02:03:34.837;113;33;89;56
39;39;2018-04-05 05:36:25.713;2018-04-05 07:47:25.327;131;34;89;55
39;39;2018-03-12 20:32:42.890;2018-03-12 21:56:16.103;84;33;89;56
39;39;2018-03-11 22:39:32.257;2018-03-12 00:01:05.130;82;34;89;55
39;39;2018-03-06 09:00:51.490;2018-03-06 10:25:30.840;85;34;89;55
39;39;2018-03-07 04:47:22.297;2018-03-07 06:11:03.380;84;32;89;57
39;39;2018-02-09 08:12:49.650;2018-02-09 10:18:22.450;126;34;89;55
39;39;2018-02-06 20:15:46.170;2018-02-06 22:12:41.510;117;33;89;56
39;39;2018-02-06 10:42:39.850;2018-02-06 11:45:32.677;63;34;64;30
39;39;2018-01-25 09:49:23.907;2018-01-25 11:46:39.913;117;34;61;27
39;39;2018-01-24 12:08:56.010;2018-01-24 14:14:31.923;126;34;59;25
39;39;2018-01-15 21:18:50.460;2018-01-16 08:47:11.033;689;34;60;26
39;39;2018-01-05 10:07:25.350;2018-01-07 22:18:27.430;3611;34;76;42
39;39;2018-01-04 03:23:06.117;2018-01-04 07:01:24.247;218;41;77;36
39;39;2018-01-02 05:47:11.467;2018-01-02 09:46:51.117;239;34;77;43
39;39;2017-12-20 15:39:20.460;2017-12-21 09:00:40.910;1041;31;79;48
39;39;2017-12-11 15:06:41.370;2017-12-12 13:04:49.617;1318;34;81;47
39;39;2017-12-05 05:45:03.113;2017-12-08 03:45:25.250;4200;63;82;19
39;39;2017-12-04 12:34:33.783;2017-12-04 15:13:36.650;159;33;89;56
39;39;2017-12-04 12:41:54.400;2017-12-04 15:13:36.650;152;33;89;56
39;39;2017-12-04 12:43:56.073;2017-12-04 15:13:36.650;150;33;89;56
39;39;2017-11-03 15:10:07.847;2017-12-02 06:41:25.253;41251;59;89;30
40;40;2017-10-03 21:53:29.463;2017-10-03 22:58:12.567;65;34;89;55
40;40;2017-10-04 10:20:10.320;2017-10-04 10:39:55.420;19;76;89;13
40;40;2017-10-02 04:04:11.280;2017-10-02 07:24:05.670;200;34;99;65
40;40;2017-11-02 10:26:29.947;2017-11-02 11:38:14.693;72;34;89;55
40;40;2017-11-08 08:14:56.927;2017-11-08 09:16:42.807;62;33;89;56
40;40;2017-11-06 16:14:54.593;2017-11-06 18:14:11.453;120;34;89;55
40;40;2017-11-10 07:03:12.170;2017-11-10 08:13:55.007;70;34;89;55
40;40;2017-11-13 13:51:57.290;2017-11-13 14:47:16.183;56;34;89;55
40;40;2017-11-15 10:42:25.657;2017-11-15 11:52:37.773;70;34;89;55
40;40;2017-11-15 10:44:27.690;2017-11-15 11:52:37.773;68;34;89;55
40;40;2017-10-30 21:51:46.560;2017-10-31 01:44:50.210;233;33;99;66
40;40;2017-10-27 14:47:00.547;2017-10-27 16:00:44.847;73;34;89;55
40;40;2017-10-26 20:09:18.413;2017-10-26 21:24:14.933;75;33;89;56
40;40;2017-10-24 08:36:59.593;2017-10-24 10:33:29.030;117;33;89;56
40;40;2017-10-24 09:04:02.470;2017-10-24 10:33:29.030;89;33;89;56
40;40;2017-10-20 09:01:37.337;2017-10-20 10:13:08.320;72;34;89;55
40;40;2017-10-19 07:37:40.173;2017-10-19 08:03:48.227;26;33;54;21
40;40;2017-10-16 04:19:18.393;2017-10-16 06:31:56.500;132;15;89;74
40;40;2017-10-13 09:55:39.693;2017-10-13 11:09:40.040;74;33;89;56
40;40;2017-10-05 21:19:45.863;2017-10-05 22:36:12.233;77;34;89;55
40;40;2017-12-01 19:43:35.030;2017-12-01 21:32:31.663;109;34;89;55
40;40;2017-12-02 02:02:21.323;2017-12-02 05:47:52.753;225;80;100;20
40;40;2017-11-30 17:16:49.900;2017-11-30 21:50:52.143;274;33;89;56
40;40;2017-12-06 23:21:18.703;2017-12-07 01:08:46.347;107;34;89;55
40;40;2017-12-08 03:45:51.287;2017-12-11 16:11:33.970;5066;78;89;11
40;40;2017-12-08 03:43:47.483;2017-12-11 16:11:33.970;5068;78;89;11
40;40;2017-11-28 18:38:33.567;2017-11-28 18:52:27.177;14;86;89;3
40;40;2017-11-27 20:47:12.837;2017-11-27 22:42:57.917;115;34;89;55
40;40;2017-11-24 06:11:38.153;2017-11-24 08:46:16.233;155;34;89;55
40;40;2017-11-25 02:01:07.037;2017-11-25 06:56:25.067;295;44;100;56
40;40;2017-11-22 13:38:49.143;2017-11-22 16:21:21.603;163;33;89;56
40;40;2017-11-23 12:33:10.403;2017-11-23 13:36:32.813;63;34;89;55
40;40;2017-12-14 10:25:49.680;2017-12-14 12:22:54.210;117;33;89;56
40;40;2017-12-14 10:34:03.727;2017-12-14 12:22:54.210;108;33;89;56
40;40;2017-12-21 19:49:18.523;2017-12-21 21:56:57.043;127;34;89;55
40;40;2018-01-03 16:23:19.680;2018-01-04 12:02:11.107;1179;77;89;12
40;40;2018-01-04 03:23:54.557;2018-01-04 12:02:11.107;519;43;89;46
40;40;2018-01-10 03:50:08.490;2018-01-10 05:49:18.477;119;34;89;55
40;40;2018-02-06 14:57:28.863;2018-02-06 16:41:03.100;104;34;89;55
40;40;2018-02-27 22:09:50.893;2018-02-27 23:28:31.033;79;34;89;55
40;40;2018-03-02 17:34:47.943;2018-03-02 18:56:57.940;82;32;89;57
40;40;2018-03-05 10:58:08.553;2018-03-05 12:33:20.650;95;34;89;55
40;40;2018-03-06 07:49:33.900;2018-03-06 09:17:05.743;88;34;89;55
40;40;2018-04-16 06:45:14.020;2018-04-16 11:49:55.540;304;31;93;62
40;40;2018-04-17 01:33:52.593;2018-04-17 03:03:24.483;90;34;89;55
40;40;2018-01-26 03:44:49.490;2018-01-26 06:19:43.590;155;34;89;55
40;40;2018-01-29 13:10:27.863;2018-01-30 07:29:16.467;1099;0;100;100
40;40;2018-01-30 03:40:42.540;2018-01-30 07:29:16.467;229;34;100;66
40;40;2018-02-15 11:14:17.217;2018-02-15 12:34:16.707;80;34;89;55
40;40;2018-02-15 11:19:35.337;2018-02-15 12:34:16.707;75;34;89;55
40;40;2018-02-16 00:49:50.733;2018-02-16 02:05:37.000;76;34;89;55
40;40;2018-02-20 06:41:40.760;2018-02-20 08:37:28.370;116;34;89;55
40;40;2018-02-21 03:19:38.360;2018-02-21 04:57:32.790;98;33;89;56
40;40;2018-02-26 11:14:25.577;2018-02-26 15:28:40.117;254;34;89;55
40;40;2018-02-23 15:16:52.903;2018-02-23 17:41:08.507;145;34;89;55
40;40;2018-03-15 09:12:49.163;2018-03-15 10:19:28.780;67;33;80;47
40;40;2018-03-23 09:11:22.443;2018-03-23 10:26:41.220;75;34;89;55
40;40;2018-03-26 00:38:44.360;2018-03-26 05:45:38.067;307;21;97;76
40;40;2018-04-17 15:25:24.577;2018-04-17 17:15:28.757;110;34;89;55
40;40;2018-04-19 15:36:47.907;2018-04-19 18:23:14.497;167;34;89;55
40;40;2018-05-16 20:19:28.773;2018-05-16 22:27:12.120;128;32;89;57
40;40;2018-05-17 14:42:41.637;2018-05-17 16:34:14.923;112;32;100;68
40;40;2018-05-04 20:57:49.613;2018-05-04 23:38:30.257;161;34;89;55
40;40;2018-05-07 15:01:56.870;2018-05-07 19:21:08.563;260;34;89;55
40;40;2018-05-08 12:56:31.473;2018-05-08 14:14:58.677;78;34;89;55
40;40;2018-05-09 22:27:27.777;2018-05-10 00:31:30.453;124;33;89;56
40;40;2018-05-09 23:01:15.030;2018-05-10 00:31:30.453;90;33;89;56
40;40;2018-05-15 04:54:42.160;2018-05-15 06:27:22.173;93;34;89;55
32;32;2017-10-27 06:57:45.500;2017-10-27 08:13:11.640;76;33;89;56
32;32;2017-10-30 08:33:31.890;2017-10-30 10:02:08.873;89;16;85;69
32;32;2017-10-30 21:03:57.857;2017-10-30 22:47:53.827;104;33;91;58
32;32;2017-10-30 21:15:56.370;2017-10-30 22:47:53.827;92;33;91;58
32;32;2017-10-30 21:18:08.580;2017-10-30 22:47:53.827;89;33;91;58
32;32;2017-11-02 12:04:11.000;2017-11-02 13:16:43.697;72;34;89;55
33;33;2017-11-03 13:28:39.630;2017-11-03 13:37:25.023;9;83;89;6
40;40;2018-06-03 23:30:36.427;2018-06-04 02:49:10.480;199;31;89;58
33;33;2017-11-06 11:30:23.337;2017-11-06 12:38:33.100;68;33;89;56
33;33;2017-10-30 12:54:36.910;2017-10-31 13:20:00.610;1466;15;96;81
33;33;2017-10-26 11:36:36.260;2017-10-26 12:46:31.440;70;34;89;55
40;40;2018-06-19 09:32:46.480;2018-06-19 10:50:34.583;78;34;89;55
40;40;2018-06-05 15:41:49.947;2018-06-05 17:17:13.883;96;33;89;56
40;40;2018-06-05 15:44:27.940;2018-06-05 17:17:13.883;93;33;89;56
40;40;2018-06-05 15:45:32.203;2018-06-05 17:17:13.883;92;33;89;56
40;40;2018-02-28 18:15:41.393;2018-02-28 19:33:30.573;78;34;89;55
40;40;2018-03-02 17:26:33.547;2018-03-02 18:56:57.940;90;32;89;57
40;40;2018-03-07 17:22:49.053;2018-03-07 18:59:32.297;97;34;89;55
40;40;2018-03-08 12:19:13.867;2018-03-08 14:04:41.903;105;34;89;55
40;40;2018-03-09 06:48:47.470;2018-03-09 08:43:53.173;115;33;89;56
40;40;2018-04-07 10:01:31.340;2018-04-07 12:56:12.790;175;42;96;54
40;40;2018-04-12 04:45:24.180;2018-04-12 06:52:43.243;127;32;89;57
40;40;2018-02-01 20:24:04.340;2018-02-01 22:25:28.960;121;33;89;56
40;40;2018-02-03 02:21:35.643;2018-02-03 04:52:27.790;151;34;89;55
40;40;2018-02-20 06:40:47.700;2018-02-20 08:37:28.370;117;34;89;55
40;40;2018-02-21 03:23:05.530;2018-02-21 04:57:32.790;94;33;89;56
40;40;2018-02-22 09:43:37.650;2018-02-22 11:42:23.357;119;29;89;60
40;40;2018-03-14 17:47:51.110;2018-03-14 19:06:11.097;79;33;89;56
40;40;2018-03-20 08:58:15.467;2018-03-20 11:12:42.777;134;33;88;55
40;40;2018-04-18 19:07:51.820;2018-04-18 21:25:48.697;138;34;89;55
40;40;2018-04-25 15:14:01.237;2018-04-25 20:05:12.057;291;33;93;60
40;40;2018-04-27 05:30:20.630;2018-04-27 06:54:32.783;84;34;89;55
40;40;2018-05-01 09:29:08.973;2018-05-01 11:07:41.353;98;33;89;56
40;40;2018-05-18 11:00:09.570;2018-05-18 12:15:42.190;75;34;89;55
40;40;2018-05-23 08:20:12.870;2018-05-23 09:52:07.297;92;34;89;55
40;40;2018-05-25 10:52:40.263;2018-05-25 12:11:56.573;79;33;89;56
40;40;2018-05-04 15:44:52.587;2018-05-04 23:38:30.257;474;34;89;55
40;40;2018-05-09 05:00:38.400;2018-05-09 06:24:14.200;84;33;89;56
40;40;2018-05-14 12:27:03.887;2018-05-14 13:55:55.540;88;34;89;55
40;40;2018-05-14 12:29:57.537;2018-05-14 13:55:55.540;86;34;89;55
40;40;2018-05-28 10:25:13.940;2018-05-28 11:52:06.450;87;33;89;56
32;32;2017-10-30 20:51:54.280;2017-10-30 22:47:53.827;116;33;91;58
32;32;2017-10-30 20:58:44.890;2017-10-30 22:47:53.827;109;33;91;58
32;32;2017-10-30 21:05:04.240;2017-10-30 22:47:53.827;102;33;91;58
32;32;2017-10-30 21:10:52.963;2017-10-30 22:47:53.827;97;33;91;58
32;32;2017-11-02 12:09:17.983;2017-11-02 13:16:43.697;67;34;89;55
33;33;2017-11-03 07:25:52.517;2017-11-03 08:30:06.367;65;34;89;55
33;33;2017-10-31 09:53:38.387;2017-10-31 13:20:00.610;207;14;96;82
33;33;2017-10-31 09:57:16.253;2017-10-31 13:20:00.610;203;14;96;82
33;33;2017-10-23 21:40:39.803;2017-10-24 04:32:43.493;412;33;100;67
33;33;2017-10-23 05:16:42.370;2017-10-24 04:32:43.493;1396;99;100;1
33;33;2017-10-25 00:01:56.977;2017-10-25 01:09:24.107;68;34;89;55
33;33;2017-10-25 00:04:31.967;2017-10-25 01:09:24.107;65;34;89;55
40;40;2018-06-04 22:45:10.750;2018-06-05 00:04:14.850;79;33;89;56
40;40;2018-06-23 10:05:37.570;2018-06-23 14:31:22.307;266;50;99;49
33;33;2017-10-23 03:42:17.810;2017-10-23 05:15:52.310;93;34;99;65
33;33;2017-10-19 21:16:30.813;2017-10-19 22:27:01.690;71;34;89;55
33;33;2017-10-19 07:05:28.113;2017-10-19 08:09:36.810;64;33;80;47
33;33;2017-10-13 13:10:25.510;2017-10-13 13:13:30.333;3;86;89;3
40;40;2018-06-27 08:09:48.030;2018-06-27 10:03:47.490;114;34;89;55
40;40;2018-06-25 13:16:46.910;2018-06-25 14:33:11.510;77;34;89;55
40;40;2018-07-12 08:07:35.480;2018-07-12 09:44:29.550;97;34;94;60
40;40;2018-06-28 08:41:31.097;2018-06-28 11:15:39.673;154;33;89;56
40;40;2018-07-16 09:00:58.260;2018-07-16 13:09:47.380;249;33;99;66
40;40;2018-07-20 06:23:00.143;2018-07-20 07:19:42.383;56;34;74;40
40;40;2018-07-31 09:05:18.323;2018-07-31 10:49:14.627;104;34;89;55
40;40;2018-08-02 21:57:33.113;2018-08-03 08:39:06.987;642;33;89;56
40;40;2018-08-03 07:17:53.037;2018-08-03 08:39:06.987;82;33;89;56
40;40;2018-08-16 05:54:36.710;2018-08-16 15:59:37.023;605;78;89;11
40;40;2018-08-16 14:40:03.123;2018-08-16 15:59:37.023;79;33;89;56
40;40;2018-08-01 07:07:52.667;2018-08-01 09:17:26.527;130;33;89;56
40;40;2018-06-08 07:17:27.743;2018-06-08 08:32:42.293;75;34;89;55
40;40;2018-06-12 14:01:41.167;2018-06-12 15:20:34.957;79;34;89;55
40;40;2018-06-11 17:00:01.350;2018-06-11 18:36:36.657;96;47;100;53
40;40;2018-07-02 13:09:42.370;2018-07-02 15:36:48.967;147;34;86;52
40;40;2018-06-18 10:51:44.633;2018-06-18 15:27:14.680;276;34;92;58
40;40;2018-07-04 10:09:17.870;2018-07-04 11:31:11.090;82;33;89;56
40;40;2018-07-04 10:11:54.097;2018-07-04 11:31:11.090;80;33;89;56
40;40;2018-07-05 23:04:54.480;2018-07-06 00:46:17.073;102;34;89;55
40;40;2018-07-24 09:08:54.237;2018-07-24 09:35:43.587;27;19;32;13
40;40;2018-07-24 09:36:22.700;2018-07-24 11:02:40.307;86;31;89;58
40;40;2018-07-25 08:03:29.293;2018-07-25 08:22:19.870;19;33;40;7
40;40;2018-07-25 08:24:27.137;2018-07-25 09:16:48.673;52;40;77;37
40;40;2018-07-28 10:02:08.120;2018-07-28 15:21:04.053;319;44;100;56
40;40;2018-08-04 03:17:54.350;2018-08-07 16:33:06.317;5116;32;57;25
40;40;2018-08-04 05:00:27.980;2018-08-07 16:33:06.317;5013;32;57;25
40;40;2018-08-07 16:13:33.557;2018-08-07 16:33:06.317;20;43;57;14
40;40;2018-08-14 07:13:38.390;2018-08-14 09:02:44.180;109;34;89;55
40;40;2018-08-14 07:21:09.767;2018-08-14 09:02:44.180;101;34;89;55
40;40;2018-08-10 11:13:29.613;2018-08-10 17:45:15.007;392;33;89;56
40;40;2018-08-10 16:13:53.917;2018-08-10 17:45:15.007;92;33;89;56
40;40;2018-08-30 14:09:21.140;2018-08-30 16:12:06.293;123;33;89;56
40;40;2018-09-03 07:25:52.970;2018-09-03 08:41:04.350;76;34;89;55
40;40;2018-09-04 22:47:37.553;2018-09-05 00:11:46.863;84;33;89;56
40;40;2018-08-20 21:19:01.287;2018-08-20 23:25:56.230;126;34;89;55
40;40;2018-08-20 21:35:06.970;2018-08-20 23:25:56.230;110;34;89;55
40;40;2018-08-20 21:50:45.420;2018-08-20 23:25:56.230;95;34;89;55
40;40;2018-08-21 14:29:30.120;2018-08-21 15:51:38.533;82;34;89;55
40;40;2018-08-22 10:12:35.433;2018-08-22 11:28:14.540;76;34;88;54
40;40;2018-09-06 10:55:13.717;2018-09-06 12:57:27.300;122;32;89;57
40;40;2018-09-09 22:39:49.940;2018-09-09 23:26:39.240;47;48;54;6
40;40;2018-09-09 23:27:25.873;2018-09-10 16:07:01.827;1000;54;100;46
40;40;2018-09-10 10:31:12.837;2018-09-10 16:07:01.827;336;34;100;66
40;40;2018-09-12 15:36:21.693;2018-09-12 17:08:17.500;92;33;89;56
40;40;2018-09-12 15:39:27.480;2018-09-12 17:08:17.500;89;33;89;56
40;40;2018-09-17 11:27:47.677;2018-09-18 10:20:02.817;1373;33;50;17
40;40;2018-09-19 21:18:50.950;2018-09-20 02:56:03.840;338;33;100;67
40;40;2018-09-18 14:42:16.973;2018-09-19 11:20:48.130;1238;33;52;19
40;40;2018-09-18 15:17:21.010;2018-09-19 11:20:48.130;1203;33;52;19
40;40;2018-09-22 10:26:30.817;2018-09-22 11:45:46.403;79;38;86;48
40;40;2018-09-24 06:40:33.677;2018-09-24 11:36:45.860;296;33;99;66
40;40;2018-09-28 17:55:36.783;2018-09-28 18:35:14.783;40;33;36;3
40;40;2018-09-28 17:57:22.990;2018-09-28 18:35:14.783;38;33;36;3
41;41;2018-09-25 19:30:00.400;2018-09-25 20:57:42.037;87;34;89;55
41;41;2018-09-25 19:31:45.107;2018-09-25 20:57:42.037;86;34;89;55
41;41;2018-09-24 01:39:53.153;2018-09-24 07:42:13.577;363;34;100;66
41;41;2018-09-22 12:01:05.997;2018-09-24 07:42:13.577;2621;79;100;21
41;41;2018-09-22 20:39:15.230;2018-09-24 07:42:13.577;2103;66;100;34
41;41;2018-09-20 15:38:46.607;2018-09-20 16:50:14.310;72;34;85;51
33;33;2017-10-11 20:54:12.843;2017-10-11 22:17:59.190;83;33;89;56
33;33;2017-10-11 21:05:31.813;2017-10-11 22:17:59.190;72;33;89;56
33;33;2017-10-11 21:10:41.763;2017-10-11 22:17:59.190;67;33;89;56
33;33;2017-10-13 07:44:20.530;2017-10-13 08:52:18.517;68;34;89;55
33;33;2017-10-13 10:18:30.677;2017-10-13 10:20:49.840;2;87;89;2
33;33;2017-10-09 10:36:44.360;2017-10-09 11:40:24.703;64;33;89;56
33;33;2017-10-03 19:19:14.923;2017-10-03 20:29:39.490;70;34;89;55
33;33;2017-10-02 07:54:03.363;2017-10-02 12:23:56.133;269;47;95;48
33;33;2018-03-05 17:01:27.053;2018-03-05 18:18:46.057;77;34;89;55
33;33;2018-03-01 20:45:51.543;2018-03-01 22:01:50.933;76;34;89;55
33;33;2018-02-14 23:17:10.227;2018-02-15 00:44:39.230;87;33;89;56
41;41;2018-09-14 09:14:32.267;2018-09-14 10:29:50.770;75;33;89;56
33;33;2018-02-12 05:09:21.983;2018-02-12 10:26:41.927;317;31;100;69
41;41;2018-09-13 05:22:38.697;2018-09-13 06:36:36.507;74;34;89;55
33;33;2018-02-07 14:57:44.387;2018-02-07 16:48:29.097;111;34;89;55
41;41;2018-09-07 07:43:54.630;2018-09-08 08:52:13.890;1509;34;89;55
33;33;2018-02-05 18:05:20.390;2018-02-06 00:38:29.930;393;33;100;67
33;33;2018-02-05 18:28:58.060;2018-02-06 00:38:29.930;370;33;100;67
33;33;2017-12-14 05:23:25.360;2017-12-14 08:03:00.190;160;34;89;55
41;41;2018-08-22 17:30:48.337;2018-08-22 19:00:09.460;90;33;89;56
33;33;2017-12-07 10:21:26.853;2017-12-07 12:12:24.493;111;34;89;55
33;33;2017-12-07 10:22:50.863;2017-12-07 12:12:24.493;110;34;89;55
33;33;2017-12-07 10:24:19.120;2017-12-07 12:12:24.493;108;34;89;55
40;40;2018-03-22 09:21:51.107;2018-03-22 14:28:30.927;307;34;91;57
40;40;2018-03-19 11:09:29.080;2018-03-19 13:10:48.730;121;33;89;56
40;40;2018-03-26 22:46:28.287;2018-03-27 00:06:01.023;80;33;89;56
40;40;2018-04-25 09:22:02.890;2018-04-25 10:18:39.857;56;27;48;21
40;40;2018-03-29 14:57:02.620;2018-03-29 17:07:56.433;130;33;89;56
40;40;2018-04-28 10:02:02.967;2018-04-28 14:08:08.503;246;68;100;32
40;40;2018-05-24 11:42:20.010;2018-05-24 13:02:26.083;80;31;89;58
40;40;2018-06-06 08:18:37.067;2018-06-06 09:44:54.910;86;33;89;56
40;40;2018-05-22 13:13:56.523;2018-05-22 14:39:52.277;86;33;89;56
40;40;2018-05-04 20:55:45.067;2018-05-04 23:38:30.257;163;34;89;55
40;40;2018-05-09 18:56:08.460;2018-05-10 00:31:30.453;335;33;89;56
40;40;2018-05-10 15:04:33.200;2018-05-10 16:41:13.710;97;34;89;55
40;40;2018-05-11 15:51:26.460;2018-05-11 17:42:52.743;111;34;89;55
40;40;2018-05-26 10:01:29.860;2018-05-26 14:56:51.237;295;41;100;59
40;40;2018-05-28 09:55:46.590;2018-05-28 11:52:06.450;117;33;89;56
40;40;2018-05-28 10:27:46.833;2018-05-28 11:52:06.450;85;33;89;56
32;32;2017-10-30 08:15:32.997;2017-10-30 10:02:08.873;107;16;85;69
32;32;2017-10-30 21:19:36.520;2017-10-30 22:47:53.827;88;33;91;58
32;32;2017-10-30 21:20:20.647;2017-10-30 22:47:53.827;87;33;91;58
32;32;2017-11-02 12:01:40.030;2017-11-02 13:16:43.697;75;34;89;55
32;32;2017-11-02 12:13:38.320;2017-11-02 13:16:43.697;63;34;89;55
32;32;2017-11-03 07:17:00.857;2017-11-03 08:25:35.613;68;34;89;55
32;32;2017-11-03 07:19:39.700;2017-11-03 08:25:35.613;66;34;89;55
33;33;2017-11-03 07:22:06.250;2017-11-03 08:30:06.367;68;34;89;55
33;33;2017-10-31 09:55:17.753;2017-10-31 13:20:00.610;205;14;96;82
33;33;2017-10-23 21:31:21.943;2017-10-24 04:32:43.493;421;33;100;67
33;33;2017-10-23 21:38:13.540;2017-10-24 04:32:43.493;414;33;100;67
40;40;2018-06-05 15:33:30.107;2018-06-05 17:17:13.883;104;33;89;56
33;33;2017-10-23 03:40:25.577;2017-10-23 05:15:52.310;95;34;99;65
33;33;2017-10-23 03:53:03.733;2017-10-23 05:15:52.310;82;34;99;65
33;33;2017-10-19 04:36:21.793;2017-10-19 08:09:36.810;213;33;80;47
40;40;2018-06-20 06:46:21.147;2018-06-20 08:09:28.980;83;34;89;55
40;40;2018-06-22 15:46:42.113;2018-06-23 14:31:22.307;1365;34;99;65
40;40;2018-06-23 10:00:52.657;2018-06-23 14:31:22.307;271;50;99;49
40;40;2018-06-26 11:54:18.250;2018-06-26 13:16:58.627;82;33;86;53
40;40;2018-06-27 08:11:06.820;2018-06-27 10:03:47.490;112;34;89;55
33;33;2017-10-16 20:32:11.170;2017-10-17 01:27:00.787;295;34;100;66
33;33;2017-10-17 17:52:36.320;2017-10-17 18:56:51.160;64;34;89;55
33;33;2017-10-13 13:07:54.627;2017-10-13 13:13:30.333;6;87;89;2
33;33;2017-10-13 17:16:04.113;2017-10-13 17:22:31.370;6;84;89;5
33;33;2017-10-11 05:32:09.937;2017-10-11 06:41:31.860;69;33;89;56
40;40;2018-06-28 08:42:35.263;2018-06-28 11:15:39.673;153;33;89;56
40;40;2018-07-17 17:40:31.953;2018-07-18 08:04:53.390;864;33;89;56
40;40;2018-07-18 06:36:41.840;2018-07-18 08:04:53.390;88;33;89;56
40;40;2018-07-20 06:24:38.497;2018-07-20 07:19:42.383;55;34;74;40
40;40;2018-08-02 01:04:21.577;2018-08-02 02:59:40.743;115;34;86;52
40;40;2018-07-19 06:33:03.247;2018-07-19 08:14:33.597;101;31;91;60
40;40;2018-08-01 07:23:45.640;2018-08-01 09:17:26.527;114;33;89;56
40;40;2018-06-14 18:20:01.390;2018-06-14 19:53:26.937;93;34;89;55
40;40;2018-06-11 16:23:11.507;2018-06-11 16:59:41.957;36;34;47;13
40;40;2018-06-18 10:26:53.030;2018-06-18 15:27:14.680;301;34;92;58
40;40;2018-06-18 10:42:38.927;2018-06-18 15:27:14.680;285;34;92;58
40;40;2018-08-04 03:56:15.220;2018-08-07 16:33:06.317;5077;32;57;25
40;40;2018-08-10 11:23:03.747;2018-08-10 17:45:15.007;382;33;89;56
40;40;2018-08-10 11:58:24.010;2018-08-10 17:45:15.007;347;33;89;56
40;40;2018-08-10 12:40:07.193;2018-08-10 17:45:15.007;305;33;89;56
40;40;2018-08-30 11:16:01.297;2018-08-30 16:12:06.293;296;32;89;57
40;40;2018-08-31 08:55:32.460;2018-08-31 10:50:18.403;115;34;92;58
40;40;2018-08-20 21:19:56.687;2018-08-20 23:25:56.230;126;34;89;55
40;40;2018-08-20 21:20:32.370;2018-08-20 23:25:56.230;125;34;89;55
40;40;2018-08-20 22:11:26.830;2018-08-20 23:25:56.230;74;34;89;55
40;40;2018-08-20 01:33:10.230;2018-08-20 04:50:42.797;197;17;100;83
40;40;2018-08-20 01:35:24.270;2018-08-20 04:50:42.797;195;16;100;84
40;40;2018-09-07 18:04:23.673;2018-09-07 19:19:36.360;75;33;89;56
40;40;2018-09-09 23:17:38.340;2018-09-09 23:26:39.240;9;48;54;6
40;40;2018-09-10 09:12:08.667;2018-09-10 16:07:01.827;415;34;100;66
40;40;2018-09-10 10:24:41.833;2018-09-10 16:07:01.827;343;34;100;66
40;40;2018-09-11 21:34:06.120;2018-09-11 22:54:26.213;80;34;89;55
40;40;2018-09-12 15:38:35.230;2018-09-12 17:08:17.500;90;33;89;56
40;40;2018-09-13 15:49:29.860;2018-09-13 17:39:03.987;110;34;89;55
40;40;2018-09-14 15:44:27.337;2018-09-14 17:00:19.320;76;34;89;55
40;40;2018-09-20 19:14:58.070;2018-09-20 20:34:38.630;80;34;89;55
40;40;2018-09-28 00:45:04.880;2018-09-28 01:54:45.000;69;61;88;27
40;40;2018-09-26 14:01:31.637;2018-09-26 15:16:14.117;75;34;83;49
40;40;2018-09-28 18:01:58.717;2018-09-28 18:35:14.783;34;33;36;3
40;40;2018-09-29 01:51:02.987;2018-09-29 03:58:17.617;127;33;87;54
40;40;2018-09-25 18:18:41.950;2018-09-25 21:03:40.577;165;33;89;56
41;41;2018-09-25 18:56:00.813;2018-09-25 20:57:42.037;121;34;89;55
41;41;2018-09-22 06:42:33.087;2018-09-22 08:06:47.737;84;31;89;58
33;33;2017-10-11 20:59:05.053;2017-10-11 22:17:59.190;78;33;89;56
33;33;2017-10-13 07:40:58.237;2017-10-13 08:52:18.517;72;34;89;55
33;33;2017-10-10 10:56:00.350;2017-10-10 12:01:11.173;65;33;89;56
33;33;2017-10-05 20:10:28.870;2017-10-05 23:37:54.560;207;33;89;56
33;33;2017-10-05 20:12:07.107;2017-10-05 23:37:54.560;205;33;89;56
33;33;2017-10-05 22:30:32.647;2017-10-05 23:37:54.560;67;33;89;56
33;33;2017-10-05 07:12:52.997;2017-10-05 08:15:14.930;63;33;89;56
33;33;2017-10-03 19:17:55.390;2017-10-03 20:29:39.490;72;34;89;55
33;33;2017-10-03 19:28:31.553;2017-10-03 20:29:39.490;61;34;89;55
41;41;2018-09-18 15:12:00.350;2018-09-18 20:04:38.403;292;49;89;40
33;33;2018-03-01 07:02:38.850;2018-03-01 08:17:52.410;75;34;89;55
41;41;2018-09-18 14:46:02.570;2018-09-18 15:09:19.307;23;34;50;16
33;33;2018-02-28 08:52:21.243;2018-02-28 10:09:04.480;77;33;89;56
41;41;2018-09-17 05:54:54.833;2018-09-17 07:09:35.707;75;34;89;55
33;33;2018-02-14 23:10:37.057;2018-02-15 00:44:39.230;94;33;89;56
33;33;2018-02-13 09:56:43.747;2018-02-13 11:15:09.190;79;34;89;55
33;33;2018-02-09 14:47:12.640;2018-02-09 16:11:24.867;84;34;89;55
33;33;2018-02-08 14:11:45.650;2018-02-08 15:53:27.293;102;34;87;53
33;33;2018-02-08 16:30:43.103;2018-02-08 16:35:02.637;5;87;89;2
41;41;2018-09-12 13:01:14.657;2018-09-12 14:22:51.817;81;33;89;56
33;33;2018-02-06 19:23:31.340;2018-02-06 21:09:56.187;106;33;89;56
33;33;2018-02-06 19:23:37.367;2018-02-06 21:09:56.187;106;33;89;56
41;41;2018-09-11 18:47:01.113;2018-09-11 20:03:58.950;76;31;89;58
41;41;2018-09-11 03:43:03.300;2018-09-11 05:18:17.550;95;34;89;55
33;33;2018-02-05 18:17:38.133;2018-02-06 00:38:29.930;381;33;100;67
33;33;2017-12-15 00:03:04.647;2017-12-15 02:16:15.977;133;33;89;56
41;41;2018-09-08 07:18:52.417;2018-09-08 08:52:13.890;94;0;89;89
33;33;2017-12-12 13:04:52.840;2017-12-12 15:36:43.157;152;24;89;65
41;41;2018-08-22 01:55:04.443;2018-08-22 03:23:07.080;88;32;89;57
33;33;2017-11-28 09:29:12.780;2017-11-28 11:31:04.417;122;33;89;56
33;33;2017-11-28 09:39:37.010;2017-11-28 11:31:04.417;112;33;89;56
41;41;2018-08-17 17:45:09.510;2018-08-17 19:15:14.147;90;33;89;56
33;33;2017-11-27 15:53:31.617;2017-11-27 15:56:45.260;3;99;100;1
33;33;2017-11-20 18:02:03.420;2017-11-20 19:06:29.673;64;34;89;55
41;41;2018-08-14 12:30:09.073;2018-08-14 12:55:31.880;25;32;45;13
33;33;2017-11-17 00:26:21.530;2017-11-17 01:28:45.023;62;33;89;56
33;33;2017-11-14 19:50:58.303;2017-11-14 20:51:22.140;61;33;89;56
41;41;2018-07-30 10:41:23.060;2018-07-30 12:21:45.777;100;34;89;55
33;33;2017-11-13 09:29:43.997;2017-11-13 10:47:46.083;78;34;89;55
33;33;2017-11-09 09:08:52.253;2017-11-13 10:47:46.083;5859;34;89;55
33;33;2017-11-09 11:56:24.200;2017-11-13 10:47:46.083;5691;34;89;55
33;33;2017-11-09 11:58:28.570;2017-11-13 10:47:46.083;5689;34;89;55
41;41;2018-07-27 08:36:35.717;2018-07-27 10:08:00.960;92;33;89;56
41;41;2018-07-27 08:44:11.903;2018-07-27 10:08:00.960;84;33;89;56
33;33;2017-11-07 06:44:28.377;2017-11-07 07:18:50.750;34;33;59;26
41;41;2018-07-10 18:55:09.287;2018-07-10 20:25:50.420;90;34;89;55
41;41;2018-07-06 07:27:46.480;2018-07-06 08:50:43.380;83;33;89;56
41;41;2018-07-09 07:38:47.410;2018-07-09 09:04:05.730;86;33;89;56
32;32;2017-11-02 12:11:03.133;2017-11-02 13:16:43.697;65;34;89;55
40;40;2018-06-05 15:43:31.997;2018-06-05 17:17:13.883;94;33;89;56
40;40;2018-06-05 15:53:02.710;2018-06-05 17:17:13.883;84;33;89;56
33;33;2017-10-23 23:50:10.593;2017-10-24 04:32:43.493;282;33;100;67
33;33;2017-10-25 15:46:06.917;2017-10-25 16:54:34.797;68;34;89;55
33;33;2017-10-20 23:22:51.947;2017-10-23 05:15:52.310;3233;33;99;66
33;33;2017-10-23 03:49:00.987;2017-10-23 05:15:52.310;86;34;99;65
40;40;2018-06-20 21:18:33.403;2018-06-20 22:50:07.430;92;33;89;56
33;33;2017-10-18 12:01:48.160;2017-10-18 13:10:20.737;69;33;89;56
33;33;2017-10-19 04:34:28.597;2017-10-19 08:09:36.810;215;33;80;47
33;33;2017-10-19 04:38:23.690;2017-10-19 08:09:36.810;211;33;80;47
33;33;2017-10-19 07:06:29.167;2017-10-19 08:09:36.810;63;33;80;47
33;33;2017-10-16 07:30:27.723;2017-10-16 07:31:21.387;1;96;97;1
40;40;2018-07-13 11:57:24.983;2018-07-13 16:29:59.307;272;34;100;66
40;40;2018-06-28 08:40:23.057;2018-06-28 11:15:39.673;155;33;89;56
40;40;2018-07-18 03:47:26.470;2018-07-18 08:04:53.390;257;33;89;56
40;40;2018-08-02 00:34:12.910;2018-08-02 02:59:40.743;145;34;86;52
40;40;2018-07-18 21:59:52.043;2018-07-19 08:14:33.597;615;34;91;57
40;40;2018-07-18 22:08:59.453;2018-07-19 08:14:33.597;606;34;91;57
40;40;2018-07-31 09:13:35.817;2018-07-31 10:49:14.627;96;34;89;55
40;40;2018-07-31 09:15:24.340;2018-07-31 10:49:14.627;94;34;89;55
40;40;2018-06-07 03:01:16.210;2018-06-07 05:25:06.413;144;34;89;55
40;40;2018-06-07 03:47:41.803;2018-06-07 05:25:06.413;98;34;89;55
40;40;2018-06-13 10:44:24.250;2018-06-13 12:05:54.627;81;34;89;55
40;40;2018-06-15 17:42:28.840;2018-06-15 19:55:30.850;133;34;89;55
40;40;2018-06-14 04:47:44.487;2018-06-14 06:15:38.117;88;34;89;55
40;40;2018-06-11 16:16:18.457;2018-06-11 16:59:41.957;43;34;47;13
40;40;2018-06-11 16:17:46.750;2018-06-11 16:59:41.957;42;34;47;13
40;40;2018-07-02 15:36:58.647;2018-07-02 17:38:29.060;122;86;91;5
40;40;2018-07-04 10:08:28.510;2018-07-04 11:31:11.090;83;33;89;56
40;40;2018-07-05 07:28:06.230;2018-07-05 09:00:04.527;92;33;89;56
40;40;2018-07-11 08:29:29.973;2018-07-11 13:03:05.507;274;0;99;99
40;40;2018-07-26 11:39:44.803;2018-07-26 13:51:44.650;132;34;89;55
40;40;2018-07-30 12:16:49.847;2018-07-30 13:42:42.537;86;34;89;55
40;40;2018-08-08 21:18:58.313;2018-08-09 02:37:14.403;319;34;100;66
40;40;2018-08-09 19:05:25.987;2018-08-09 20:32:56.970;87;33;89;56
40;40;2018-08-15 01:20:48.100;2018-08-15 02:40:18.807;80;31;89;58
40;40;2018-08-15 22:01:11.640;2018-08-15 22:27:47.113;26;69;86;17
40;40;2018-08-13 12:31:49.950;2018-08-13 14:06:47.767;95;34;93;59
40;40;2018-08-13 12:40:25.287;2018-08-13 14:06:47.767;86;33;93;60
40;40;2018-08-14 07:07:20.253;2018-08-14 09:02:44.180;115;34;89;55
40;40;2018-08-28 20:24:33.563;2018-08-28 22:00:44.520;96;34;89;55
40;40;2018-08-10 12:12:55.547;2018-08-10 17:45:15.007;333;33;89;56
40;40;2018-08-30 13:55:42.463;2018-08-30 16:12:06.293;137;33;89;56
40;40;2018-09-04 13:21:13.780;2018-09-05 00:11:46.863;650;34;89;55
40;40;2018-08-20 22:01:29.500;2018-08-20 23:25:56.230;84;34;89;55
40;40;2018-08-20 22:07:33.443;2018-08-20 23:25:56.230;78;34;89;55
40;40;2018-09-07 04:22:00.647;2018-09-07 05:37:46.357;75;33;89;56
40;40;2018-09-10 09:34:41.020;2018-09-10 16:07:01.827;393;34;100;66
40;40;2018-09-10 10:33:08.383;2018-09-10 16:07:01.827;334;34;100;66
40;40;2018-09-10 10:36:51.030;2018-09-10 16:07:01.827;331;34;100;66
40;40;2018-09-12 15:21:30.830;2018-09-12 17:08:17.500;107;33;89;56
40;40;2018-09-12 15:24:08.377;2018-09-12 17:08:17.500;104;33;89;56
40;40;2018-09-18 15:11:58.410;2018-09-19 11:20:48.130;1209;33;52;19
40;40;2018-09-18 15:21:28.027;2018-09-19 11:20:48.130;1199;33;52;19
40;40;2018-09-19 10:52:08.667;2018-09-19 11:20:48.130;28;34;52;18
40;40;2018-09-19 11:20:54.580;2018-09-19 11:46:45.400;26;52;72;20
40;40;2018-09-21 11:42:40.340;2018-09-21 12:36:13.750;54;36;73;37
40;40;2018-09-22 10:16:04.600;2018-09-22 11:45:46.403;89;38;86;48
40;40;2018-09-27 23:33:39.580;2018-09-28 00:22:41.543;49;34;61;27
40;40;2018-09-27 23:37:34.047;2018-09-28 00:22:41.543;45;34;61;27
41;41;2018-09-24 21:45:06.077;2018-09-24 21:55:50.680;10;34;35;1
41;41;2018-09-24 02:26:19.990;2018-09-24 07:42:13.577;316;34;100;66
41;41;2018-09-24 02:28:25.047;2018-09-24 07:42:13.577;314;34;100;66
33;33;2017-10-11 20:49:22.667;2017-10-11 22:17:59.190;88;33;89;56
33;33;2017-10-11 20:55:05.360;2017-10-11 22:17:59.190;82;33;89;56
33;33;2017-10-13 07:46:24.247;2017-10-13 08:52:18.517;66;34;89;55
33;33;2017-10-10 10:42:27.287;2017-10-10 12:01:11.173;79;33;89;56
33;33;2017-10-09 10:31:51.820;2017-10-09 11:40:24.703;69;33;89;56
33;33;2017-10-09 21:06:11.180;2017-10-09 22:15:34.803;69;33;89;56
33;33;2017-10-09 21:11:08.770;2017-10-09 22:15:34.803;64;33;89;56
33;33;2017-10-03 03:42:29.833;2017-10-03 05:06:59.460;84;33;98;65
33;33;2017-10-02 11:05:49.507;2017-10-02 12:23:56.133;78;34;95;61
33;33;2017-10-02 11:06:17.750;2017-10-02 12:23:56.133;77;34;95;61
41;41;2018-09-18 18:45:59.623;2018-09-18 20:04:38.403;79;33;89;56
33;33;2018-03-05 16:58:10.197;2018-03-05 18:18:46.057;80;34;89;55
33;33;2018-02-14 03:50:51.657;2018-02-14 05:11:03.850;81;34;89;55
33;33;2018-02-13 09:53:37.167;2018-02-13 11:15:09.190;82;34;89;55
33;33;2018-02-08 14:06:39.550;2018-02-08 15:53:27.293;107;34;87;53
33;33;2018-02-06 19:16:52.033;2018-02-06 21:09:56.187;113;33;89;56
41;41;2018-09-08 07:33:26.930;2018-09-08 08:52:13.890;79;30;89;59
33;33;2017-12-14 05:51:07.563;2017-12-14 08:03:00.190;132;34;89;55
33;33;2017-12-13 09:59:29.573;2017-12-13 12:06:01.843;127;33;89;56
41;41;2018-09-06 14:07:11.833;2018-09-06 15:40:55.620;93;33;89;56
33;33;2017-12-12 13:02:41.037;2017-12-12 15:36:43.157;154;26;89;63
33;33;2017-12-07 10:25:37.113;2017-12-07 12:12:24.493;107;34;89;55
33;33;2017-12-05 05:40:58.487;2017-12-05 06:56:32.543;76;46;89;43
33;33;2017-12-04 12:34:00.800;2017-12-04 15:03:53.020;149;33;89;56
33;33;2017-12-04 12:42:29.483;2017-12-04 15:03:53.020;141;33;89;56
33;33;2017-12-04 13:10:43.243;2017-12-04 15:03:53.020;113;33;89;56
33;33;2017-12-01 13:49:19.923;2017-12-01 15:34:42.613;105;33;89;56
33;33;2017-11-28 09:30:22.243;2017-11-28 11:31:04.417;121;33;89;56
33;33;2017-11-30 11:10:35.353;2017-11-30 12:56:02.850;106;34;89;55
33;33;2017-11-29 06:47:12.983;2017-11-29 08:46:58.013;119;33;89;56
41;41;2018-08-17 17:45:10.747;2018-08-17 19:15:14.147;90;33;89;56
41;41;2018-08-17 17:45:11.577;2018-08-17 19:15:14.147;90;33;89;56
33;33;2017-11-27 13:23:25.043;2017-11-27 15:50:51.753;147;65;99;34
33;33;2017-11-22 07:49:18.590;2017-11-22 09:03:13.453;74;34;89;55
33;33;2017-11-20 06:16:24.260;2017-11-20 07:28:56.257;72;34;89;55
33;33;2017-11-17 18:01:00.783;2017-11-17 18:08:55.387;7;84;89;5
33;33;2017-11-16 07:58:11.947;2017-11-16 08:58:25.493;60;34;89;55
33;33;2017-11-14 19:47:29.780;2017-11-14 20:51:22.140;64;33;89;56
33;33;2017-11-15 01:54:59.080;2017-11-15 02:03:27.200;9;83;89;6
33;33;2017-11-13 09:28:32.170;2017-11-13 10:47:46.083;79;34;89;55
33;33;2017-11-09 11:57:43.527;2017-11-13 10:47:46.083;5690;34;89;55
33;33;2017-11-08 16:32:36.750;2017-11-08 17:47:39.027;75;34;89;55
33;33;2017-11-02 06:33:33.230;2017-11-02 10:41:07.483;248;33;100;67
41;41;2018-07-30 10:57:55.323;2018-07-30 12:21:45.777;84;34;89;55
41;41;2018-07-24 18:48:50.847;2018-07-24 23:54:22.333;306;33;100;67
41;41;2018-07-04 05:22:42.347;2018-07-04 06:46:42.880;84;33;89;56
41;41;2018-06-13 03:38:34.403;2018-06-13 09:19:56.000;341;32;89;57
41;41;2018-06-13 07:53:49.913;2018-06-13 09:19:56.000;86;33;89;56
41;41;2018-08-16 11:07:42.010;2018-08-16 11:32:06.697;25;34;51;17
41;41;2018-08-02 13:10:18.143;2018-08-02 14:50:15.040;100;33;89;56
41;41;2018-08-01 15:21:13.693;2018-08-01 17:05:38.280;104;33;89;56
41;41;2018-07-19 21:10:07.420;2018-07-20 09:40:54.250;750;33;89;56
41;41;2018-07-18 12:17:02.567;2018-07-19 07:44:24.617;1167;33;81;48
41;41;2018-07-12 08:41:22.483;2018-07-12 09:59:12.717;78;33;86;53
41;41;2018-07-12 08:48:23.860;2018-07-12 09:59:12.717;71;33;86;53
41;41;2018-07-13 01:48:46.503;2018-07-13 03:02:01.627;74;34;89;55
41;41;2018-06-27 05:45:40.720;2018-06-27 07:53:33.903;128;66;99;33
41;41;2018-06-25 09:48:18.030;2018-06-25 13:16:47.253;208;35;99;64
41;41;2018-06-25 09:36:03.477;2018-06-25 09:47:52.253;11;33;35;2
41;41;2018-06-20 21:39:46.073;2018-06-20 23:21:49.487;102;34;89;55
41;41;2018-06-05 11:37:15.767;2018-06-05 14:57:38.823;200;34;100;66
41;41;2018-06-04 09:44:22.473;2018-06-04 13:26:32.107;222;33;99;66
41;41;2018-05-31 16:55:17.963;2018-05-31 18:12:55.390;77;34;85;51
33;33;2017-10-23 21:35:51.330;2017-10-24 04:32:43.493;417;33;100;67
33;33;2017-10-23 21:39:50.443;2017-10-24 04:32:43.493;413;33;100;67
33;33;2017-10-23 23:50:50.047;2017-10-24 04:32:43.493;282;33;100;67
33;33;2017-10-23 03:45:36.957;2017-10-23 05:15:52.310;90;34;99;65
33;33;2017-10-19 04:35:39.723;2017-10-19 08:09:36.810;214;33;80;47
33;33;2017-10-19 07:07:30.177;2017-10-19 08:09:36.810;62;33;80;47
33;33;2017-10-19 07:10:05.687;2017-10-19 08:09:36.810;59;33;80;47
40;40;2018-06-21 18:08:59.573;2018-06-21 19:51:14.433;103;34;89;55
40;40;2018-06-26 11:47:45.703;2018-06-26 13:16:58.627;89;33;86;53
40;40;2018-06-26 11:51:25.080;2018-06-26 13:16:58.627;85;33;86;53
40;40;2018-06-26 13:18:48.227;2018-06-26 13:19:36.177;1;85;86;1
33;33;2017-10-16 06:20:04.580;2017-10-16 07:28:21.573;68;34;97;63
33;33;2017-10-13 11:26:19.717;2017-10-13 11:27:57.330;1;88;89;1
33;33;2017-10-11 05:36:27.683;2017-10-11 06:41:31.860;65;33;89;56
33;33;2017-10-10 13:04:39.367;2017-10-11 06:41:31.860;1057;88;89;1
33;33;2017-10-11 21:02:27.517;2017-10-11 22:17:59.190;75;33;89;56
33;33;2017-10-10 10:51:40.580;2017-10-10 12:01:11.173;70;33;89;56
40;40;2018-08-02 00:54:46.593;2018-08-02 02:59:40.743;125;34;86;52
40;40;2018-07-31 09:00:01.313;2018-07-31 10:49:14.627;109;34;89;55
40;40;2018-07-31 09:05:57.650;2018-07-31 10:49:14.627;104;34;89;55
40;40;2018-06-09 10:01:48.830;2018-06-09 21:14:58.830;673;61;99;38
40;40;2018-06-11 16:24:00.600;2018-06-11 16:59:41.957;35;34;47;13
40;40;2018-07-03 14:15:12.313;2018-07-03 15:35:50.983;80;33;89;56
40;40;2018-07-25 09:18:02.850;2018-07-25 09:32:30.140;14;77;84;7
40;40;2018-07-27 08:25:44.763;2018-07-27 11:03:07.097;158;34;89;55
40;40;2018-08-04 03:37:16.503;2018-08-07 16:33:06.317;5096;32;57;25
40;40;2018-08-04 04:02:05.430;2018-08-07 16:33:06.317;5071;32;57;25
40;40;2018-08-04 04:47:34.080;2018-08-07 16:33:06.317;5026;32;57;25
40;40;2018-08-08 02:19:11.027;2018-08-09 02:37:14.403;1458;34;100;66
40;40;2018-08-13 12:31:12.490;2018-08-13 14:06:47.767;95;34;93;59
40;40;2018-08-13 12:34:42.797;2018-08-13 14:06:47.767;92;34;93;59
40;40;2018-08-29 16:03:00.917;2018-08-29 17:51:57.637;108;33;89;56
40;40;2018-08-10 11:18:40.027;2018-08-10 17:45:15.007;387;33;89;56
40;40;2018-08-10 11:40:30.440;2018-08-10 17:45:15.007;365;33;89;56
40;40;2018-08-10 12:42:39.333;2018-08-10 17:45:15.007;303;33;89;56
40;40;2018-09-03 20:50:20.963;2018-09-03 22:07:52.743;77;33;89;56
40;40;2018-09-05 15:57:58.020;2018-09-05 17:25:39.470;88;34;89;55
40;40;2018-08-20 22:06:35.877;2018-08-20 23:25:56.230;79;34;89;55
40;40;2018-08-20 22:12:55.880;2018-08-20 23:25:56.230;73;34;89;55
40;40;2018-09-06 11:00:48.623;2018-09-06 12:57:27.300;117;32;89;57
40;40;2018-09-06 11:08:07.243;2018-09-06 12:57:27.300;109;32;89;57
40;40;2018-09-06 11:51:54.737;2018-09-06 12:57:27.300;66;50;89;39
40;40;2018-09-11 08:00:46.800;2018-09-11 09:16:36.843;76;34;89;55
40;40;2018-09-12 15:20:15.793;2018-09-12 17:08:17.500;108;33;89;56
40;40;2018-09-12 15:20:53.497;2018-09-12 17:08:17.500;108;33;89;56
40;40;2018-09-12 15:22:09.757;2018-09-12 17:08:17.500;106;33;89;56
40;40;2018-09-12 15:37:41.057;2018-09-12 17:08:17.500;91;33;89;56
40;40;2018-09-18 09:53:01.503;2018-09-18 10:20:02.817;27;34;50;16
40;40;2018-09-19 10:46:24.170;2018-09-19 11:20:48.130;34;34;52;18
40;40;2018-09-22 10:01:32.263;2018-09-22 11:45:46.403;104;38;86;48
40;40;2018-09-27 08:12:31.127;2018-09-27 09:30:56.847;78;33;83;50
40;40;2018-09-25 05:21:29.080;2018-09-25 06:42:52.013;81;33;89;56
40;40;2018-09-29 01:53:42.163;2018-09-29 03:58:17.617;125;33;87;54
40;40;2018-09-25 19:29:42.167;2018-09-25 21:03:40.577;94;33;89;56
41;41;2017-10-02 00:44:59.453;2017-10-02 02:20:29.500;96;33;95;62
41;41;2018-09-25 03:27:11.867;2018-09-25 04:50:21.083;83;33;89;56
41;41;2018-09-24 02:27:23.960;2018-09-24 07:42:13.577;315;34;100;66
33;33;2017-10-09 21:08:53.820;2017-10-09 22:15:34.803;67;33;89;56
33;33;2017-10-05 22:32:23.243;2017-10-05 23:37:54.560;65;33;89;56
33;33;2017-10-05 07:05:29.993;2017-10-05 08:15:14.930;70;33;89;56
33;33;2017-10-03 03:40:20.973;2017-10-03 05:06:59.460;86;33;98;65
33;33;2017-10-03 19:15:07.213;2017-10-03 20:29:39.490;74;34;89;55
33;33;2017-10-03 19:21:04.150;2017-10-03 20:29:39.490;68;34;89;55
33;33;2017-10-03 20:48:17.197;2017-10-03 20:48:50.740;0;88;89;1
33;33;2017-10-04 04:00:21.457;2017-10-04 04:12:08.623;12;81;89;8
41;41;2018-09-21 07:22:59.600;2018-09-21 08:41:01.053;79;34;89;55
33;33;2018-03-01 20:22:21.037;2018-03-01 22:01:50.933;99;38;89;51
33;33;2018-03-01 06:58:09.077;2018-03-01 08:17:52.410;79;34;89;55
33;33;2018-02-14 23:20:51.137;2018-02-15 00:44:39.230;84;33;89;56
33;33;2018-02-14 03:46:16.300;2018-02-14 05:11:03.850;85;34;89;55
41;41;2018-09-13 19:58:35.400;2018-09-13 21:01:50.190;63;33;78;45
33;33;2018-02-09 14:49:51.053;2018-02-09 16:11:24.867;82;34;89;55
33;33;2018-02-08 14:14:11.523;2018-02-08 15:53:27.293;99;34;87;53
41;41;2018-09-10 12:24:17.960;2018-09-10 13:51:31.090;87;33;89;56
33;33;2018-02-07 15:01:42.630;2018-02-07 16:48:29.097;107;34;89;55
33;33;2018-02-05 18:25:23.460;2018-02-06 00:38:29.930;373;33;100;67
33;33;2018-02-05 18:27:49.020;2018-02-06 00:38:29.930;371;33;100;67
33;33;2018-02-04 22:37:48.500;2018-02-06 00:38:29.930;1561;42;100;58
33;33;2017-12-12 13:03:30.230;2017-12-12 15:36:43.157;153;26;89;63
33;33;2017-12-12 13:09:00.020;2017-12-12 15:36:43.157;147;23;89;66
33;33;2017-12-07 10:27:43.927;2017-12-07 12:12:24.493;105;34;89;55
33;33;2017-12-10 23:18:18.893;2017-12-11 01:14:56.320;116;32;89;57
33;33;2017-12-04 13:16:24.290;2017-12-04 15:03:53.020;107;33;89;56
33;33;2017-12-02 08:01:29.850;2017-12-02 13:27:12.127;326;46;100;54
41;41;2018-08-21 07:01:57.847;2018-08-21 09:32:16.107;151;33;89;56
41;41;2018-08-21 07:48:03.370;2018-08-21 09:32:16.107;104;33;89;56
33;33;2017-11-28 09:31:56.657;2017-11-28 11:31:04.417;120;33;89;56
33;33;2017-11-27 13:14:02.417;2017-11-27 15:50:51.753;156;66;99;33
41;41;2018-08-13 16:54:06.990;2018-08-14 12:55:31.880;1201;34;45;11
41;41;2018-08-12 22:41:54.107;2018-08-14 12:55:31.880;2294;32;45;13
33;33;2017-11-23 12:19:11.100;2017-11-23 13:29:00.970;70;34;89;55
33;33;2017-11-20 06:24:49.533;2017-11-20 07:28:56.257;64;34;89;55
41;41;2018-08-10 08:41:21.687;2018-08-10 09:59:30.140;78;34;89;55
41;41;2018-08-08 04:38:59.383;2018-08-08 06:32:09.413;114;34;92;58
33;33;2017-11-21 13:18:00.063;2017-11-21 13:54:09.467;36;59;89;30
41;41;2018-08-08 23:32:07.573;2018-08-09 01:04:05.417;92;33;89;56
33;33;2017-11-15 14:25:43.433;2017-11-15 15:25:18.810;60;33;89;56
41;41;2018-07-26 15:01:45.057;2018-07-27 10:08:00.960;1147;34;89;55
33;33;2017-11-14 00:49:55.083;2017-11-14 02:09:12.513;80;34;89;55
33;33;2017-11-13 09:26:22.327;2017-11-13 10:47:46.083;81;34;89;55
33;33;2017-11-13 09:27:31.763;2017-11-13 10:47:46.083;80;34;89;55
33;33;2017-11-09 09:12:57.463;2017-11-13 10:47:46.083;5855;34;89;55
33;33;2017-11-08 06:46:14.960;2017-11-08 17:47:39.027;661;34;89;55
41;41;2018-07-25 19:16:16.593;2018-07-25 20:34:50.267;78;33;89;56
33;33;2017-11-07 12:51:20.593;2017-11-08 06:41:12.170;1070;32;34;2
41;41;2018-07-24 08:23:58.303;2018-07-24 09:26:43.930;63;31;75;44
41;41;2018-07-11 11:50:54.930;2018-07-11 13:17:15.907;87;34;93;59
41;41;2018-06-12 08:59:10.970;2018-06-12 10:31:55.490;92;34;89;55
41;41;2018-06-13 04:41:50.887;2018-06-13 09:19:56.000;278;39;89;50
41;41;2018-08-16 11:32:13.220;2018-08-16 16:26:23.623;294;51;100;49
41;41;2018-08-07 11:09:31.383;2018-08-07 12:37:41.897;88;33;82;49
41;41;2018-08-03 08:19:23.620;2018-08-03 10:05:30.603;106;34;89;55
41;41;2018-07-31 21:24:09.780;2018-07-31 22:54:05.900;90;34;89;55
41;41;2018-08-01 15:32:40.560;2018-08-01 17:05:38.280;93;33;89;56
41;41;2018-07-31 03:44:24.800;2018-07-31 05:12:18.073;88;34;89;55
41;41;2018-07-18 23:58:14.493;2018-07-19 07:44:24.617;466;33;81;48
41;41;2018-07-17 19:49:13.637;2018-07-17 21:04:17.430;75;33;89;56
41;41;2018-06-27 04:56:39.050;2018-06-27 05:45:31.730;49;34;66;32
41;41;2018-06-24 20:30:27.447;2018-06-25 09:47:52.253;797;17;35;18
41;41;2018-06-21 18:06:48.253;2018-06-21 20:13:49.127;127;34;93;59
41;41;2018-06-02 09:26:10.287;2018-06-02 10:42:13.540;76;34;89;55
41;41;2018-05-29 20:40:38.670;2018-05-30 09:28:28.400;768;34;89;55
41;41;2018-05-30 22:48:36.303;2018-05-31 00:16:02.543;88;34;89;55
41;41;2018-06-06 22:28:47.130;2018-06-07 00:04:12.223;96;34;89;55
41;41;2018-06-06 22:39:28.510;2018-06-07 00:04:12.223;85;34;89;55
41;41;2018-06-06 22:43:48.847;2018-06-07 00:04:12.223;81;34;89;55
41;41;2018-05-25 16:04:24.307;2018-05-25 17:24:13.887;80;34;89;55
33;33;2017-12-01 00:30:55.633;2017-12-01 02:19:47.370;109;34;89;55
33;33;2017-11-28 09:27:15.993;2017-11-28 11:31:04.417;124;33;89;56
41;41;2018-08-21 08:03:32.373;2018-08-21 09:32:16.107;89;33;89;56
41;41;2018-08-20 11:56:44.630;2018-08-20 13:24:24.537;88;34;89;55
41;41;2018-08-14 12:27:57.150;2018-08-14 12:55:31.880;28;32;45;13
33;33;2017-11-24 05:35:02.017;2017-11-24 06:43:49.413;68;34;89;55
33;33;2017-11-22 07:53:46.080;2017-11-22 09:03:13.453;70;34;89;55
33;33;2017-11-22 07:55:25.770;2017-11-22 09:03:13.453;68;34;89;55
33;33;2017-11-22 07:57:01.950;2017-11-22 09:03:13.453;66;34;89;55
41;41;2018-08-09 15:55:20.770;2018-08-09 17:14:30.650;79;33;89;56
33;33;2017-11-21 12:46:31.090;2017-11-21 13:17:54.313;31;33;59;26
41;41;2018-08-08 23:45:29.730;2018-08-09 01:04:05.417;79;33;89;56
33;33;2017-11-17 16:48:46.060;2017-11-17 17:54:06.290;66;34;84;50
33;33;2017-11-17 16:55:33.970;2017-11-17 17:54:06.290;59;34;84;50
33;33;2017-11-14 19:52:19.170;2017-11-14 20:51:22.140;59;33;89;56
33;33;2017-11-09 09:11:51.677;2017-11-13 10:47:46.083;5856;34;89;55
33;33;2017-11-08 06:45:34.990;2017-11-08 17:47:39.027;662;34;89;55
33;33;2017-11-08 06:47:18.890;2017-11-08 17:47:39.027;660;34;89;55
33;33;2017-11-02 06:35:23.700;2017-11-02 10:41:07.483;246;33;100;67
41;41;2018-07-09 07:32:00.417;2018-07-09 09:04:05.730;92;33;89;56
41;41;2018-07-10 05:06:13.833;2018-07-10 06:33:40.110;87;34;89;55
41;41;2018-07-02 10:33:47.937;2018-07-02 14:37:42.710;244;33;100;67
41;41;2018-06-14 17:32:38.247;2018-06-14 19:00:01.677;88;34;89;55
41;41;2018-06-11 12:15:20.030;2018-06-11 13:34:09.680;79;34;89;55
41;41;2018-08-03 08:25:43.983;2018-08-03 10:05:30.603;100;34;89;55
41;41;2018-07-20 08:19:38.680;2018-07-20 09:40:54.250;81;33;89;56
41;41;2018-07-19 20:33:27.337;2018-07-20 09:40:54.250;787;33;89;56
41;41;2018-07-19 21:06:46.970;2018-07-20 09:40:54.250;754;33;89;56
41;41;2018-07-19 06:31:32.760;2018-07-19 07:44:24.617;73;32;81;49
41;41;2018-07-18 12:14:48.687;2018-07-19 07:44:24.617;1170;33;81;48
41;41;2018-07-18 12:16:10.590;2018-07-19 07:44:24.617;1168;33;81;48
41;41;2018-07-13 15:22:59.717;2018-07-13 16:37:13.230;75;34;89;55
41;41;2018-07-17 05:11:13.927;2018-07-17 06:26:36.957;75;34;89;55
41;41;2018-07-16 11:06:43.513;2018-07-16 12:19:07.400;73;34;89;55
41;41;2018-06-26 11:13:00.990;2018-06-26 12:55:37.137;102;33;91;58
41;41;2018-06-26 11:18:19.317;2018-06-26 12:55:37.137;97;33;91;58
41;41;2018-06-22 14:26:24.890;2018-06-22 15:39:43.747;73;34;89;55
41;41;2018-06-20 03:17:22.293;2018-06-20 04:55:44.510;98;33;89;56
41;41;2018-06-01 10:29:02.003;2018-06-01 11:54:06.987;85;33;93;60
41;41;2018-05-29 05:30:33.890;2018-05-29 06:58:07.077;88;32;89;57
41;41;2018-05-30 07:49:41.920;2018-05-30 09:28:28.400;99;34;89;55
41;41;2018-05-10 20:23:38.747;2018-05-10 22:12:39.560;109;33;89;56
41;41;2018-05-25 11:35:54.127;2018-05-25 17:24:13.887;349;46;89;43
41;41;2018-05-21 09:43:46.030;2018-05-21 12:44:19.080;181;34;89;55
41;41;2018-05-02 20:45:05.967;2018-05-02 21:47:45.943;62;34;76;42
41;41;2018-05-15 07:38:53.810;2018-05-15 10:18:14.163;160;34;89;55
41;41;2018-04-24 12:02:37.870;2018-04-24 13:18:50.837;76;34;89;55
41;41;2018-04-25 19:00:19.033;2018-04-25 20:22:01.917;82;34;89;55
33;33;2018-02-20 21:09:45.680;2018-02-20 22:43:39.510;94;34;89;55
33;33;2018-02-19 10:26:07.957;2018-02-19 11:55:43.240;89;34;89;55
33;33;2018-02-20 05:19:52.963;2018-02-20 06:52:04.347;93;33;89;56
41;41;2018-03-26 13:50:15.697;2018-03-26 15:05:53.493;75;34;89;55
33;33;2018-02-15 18:51:21.243;2018-02-15 20:15:01.140;84;34;89;55
41;41;2018-03-19 10:12:30.957;2018-03-19 11:28:55.383;76;34;89;55
41;41;2018-03-16 15:27:27.877;2018-03-16 16:46:38.153;79;33;89;56
33;33;2018-01-29 07:55:34.370;2018-01-29 09:51:20.637;116;34;89;55
41;41;2018-03-15 14:44:57.420;2018-03-15 16:02:37.050;78;33;89;56
41;41;2018-02-01 13:04:47.143;2018-02-01 14:51:25.900;107;34;89;55
41;41;2018-02-02 11:18:13.190;2018-02-02 13:08:30.537;110;33;89;56
33;33;2018-01-24 07:25:30.887;2018-01-24 09:16:34.090;111;33;89;56
41;41;2018-01-30 22:30:11.430;2018-01-31 00:17:30.283;107;33;89;56
33;33;2018-01-19 06:46:34.197;2018-01-19 08:31:49.453;105;30;89;59
41;41;2018-05-03 10:13:43.643;2018-05-03 11:40:24.493;87;34;89;55
41;41;2018-04-11 05:43:23.147;2018-04-11 08:02:37.013;139;33;88;55
33;33;2018-01-17 07:58:49.053;2018-01-17 10:02:32.400;124;34;89;55
33;33;2018-01-17 08:06:11.227;2018-01-17 10:02:32.400;116;34;89;55
41;41;2018-03-08 08:54:22.030;2018-03-08 10:58:07.943;124;33;89;56
41;41;2018-03-06 06:18:59.490;2018-03-06 08:17:08.610;119;34;89;55
41;41;2018-03-06 06:21:29.580;2018-03-06 08:17:08.610;116;34;89;55
41;41;2018-03-06 06:24:35.707;2018-03-06 08:17:08.610;113;34;89;55
41;41;2018-03-02 13:27:15.453;2018-03-02 15:32:19.007;125;31;89;58
41;41;2018-03-02 13:31:24.740;2018-03-02 15:32:19.007;121;31;89;58
41;41;2018-03-01 10:04:34.607;2018-03-01 11:40:47.737;96;34;89;55
41;41;2018-02-28 15:37:43.280;2018-02-28 17:13:45.987;96;33;89;56
41;41;2018-02-15 01:18:17.087;2018-02-15 02:47:52.460;89;34;89;55
41;41;2018-02-27 19:43:38.760;2018-02-27 21:24:58.663;101;34;89;55
41;41;2018-02-27 19:51:56.910;2018-02-27 21:24:58.663;93;34;89;55
41;41;2018-02-14 04:13:43.723;2018-02-14 05:41:12.403;88;34;89;55
33;33;2018-01-10 04:31:45.937;2018-01-10 06:24:31.873;113;34;89;55
41;41;2018-02-13 10:24:59.013;2018-02-13 11:55:12.193;91;34;89;55
41;41;2018-01-18 14:58:24.700;2018-01-18 16:56:49.240;118;34;89;55
41;41;2018-01-16 15:29:36.357;2018-01-16 17:22:43.533;113;34;89;55
41;41;2018-01-08 20:02:32.160;2018-01-08 21:45:59.887;103;33;89;56
33;33;2018-01-08 04:20:50.723;2018-01-08 06:08:28.403;108;34;89;55
41;41;2018-01-07 22:31:30.340;2018-01-08 00:08:55.973;97;84;100;16
33;33;2018-01-03 15:00:32.847;2018-01-03 16:30:21.410;90;33;75;42
33;33;2017-12-28 10:47:09.427;2018-01-02 11:31:03.187;7244;31;68;37
33;33;2017-12-28 10:48:19.347;2018-01-02 11:31:03.187;7243;31;68;37
41;41;2017-12-21 10:42:04.830;2017-12-21 13:33:42.677;171;36;89;53
41;41;2017-12-20 10:16:02.987;2017-12-20 12:03:44.480;107;34;89;55
33;33;2017-12-21 06:36:10.330;2017-12-21 08:18:40.420;102;34;89;55
33;33;2017-12-21 06:37:40.853;2017-12-21 08:18:40.420;101;34;89;55
41;41;2017-12-18 10:37:15.320;2017-12-18 13:13:40.667;156;34;89;55
41;41;2017-12-18 10:40:11.687;2017-12-18 13:13:40.667;153;34;89;55
41;41;2017-11-23 09:15:56.090;2017-11-23 10:20:48.290;65;34;83;49
33;33;2018-03-12 15:25:00.853;2018-03-12 16:47:24.460;82;33;89;56
33;33;2018-03-11 22:02:42.260;2018-03-11 23:33:10.153;91;31;89;58
41;41;2017-11-25 04:02:08.443;2017-11-25 08:43:54.090;281;68;100;32
41;41;2017-11-28 17:28:18.757;2017-11-28 17:40:50.537;12;82;89;7
41;41;2017-11-29 09:09:38.167;2017-11-29 10:52:33.737;103;33;85;52
41;41;2017-11-29 22:38:44.217;2017-11-30 00:31:04.780;113;33;89;56
41;41;2017-12-07 08:56:25.390;2017-12-07 10:49:22.787;113;34;89;55
41;41;2017-12-05 17:59:54.200;2017-12-05 19:52:06.540;113;32;89;57
41;41;2017-12-01 08:32:10.880;2017-12-01 10:30:36.947;118;34;89;55
41;41;2017-11-30 15:04:03.377;2017-11-30 16:58:03.397;114;33;89;56
33;33;2018-04-05 06:31:50.180;2018-04-05 09:02:11.523;151;33;89;56
41;41;2017-10-18 10:59:02.687;2017-10-18 13:17:05.333;138;34;89;55
41;41;2017-11-02 09:25:57.637;2017-11-02 10:57:32.100;92;34;89;55
33;33;2017-12-18 16:09:08.757;2017-12-18 18:33:37.453;144;32;89;57
41;41;2017-11-15 07:04:20.503;2017-11-15 08:13:19.977;69;34;89;55
41;41;2017-11-15 19:31:35.600;2017-11-15 20:43:07.163;72;33;89;56
41;41;2017-11-17 09:41:22.760;2017-11-17 10:52:38.157;71;34;89;55
41;41;2017-11-13 08:52:36.150;2017-11-13 09:56:52.037;64;33;89;56
41;41;2017-11-08 06:51:12.243;2017-11-08 15:13:02.500;502;34;89;55
41;41;2017-11-08 06:55:28.910;2017-11-08 15:13:02.500;498;34;89;55
41;41;2017-11-08 07:03:43.493;2017-11-08 15:13:02.500;490;34;89;55
33;33;2018-02-23 12:35:11.510;2018-02-23 13:50:07.603;75;34;89;55
33;33;2018-03-21 20:00:59.360;2018-03-21 21:39:03.073;99;34;89;55
33;33;2018-03-28 10:01:53.160;2018-03-28 12:10:29.563;129;31;89;58
33;33;2018-04-18 09:13:14.323;2018-04-18 10:11:54.870;58;33;74;41
33;33;2018-04-20 09:09:33.117;2018-04-20 11:36:09.387;147;34;89;55
33;33;2018-04-20 09:13:39.853;2018-04-20 11:36:09.387;143;34;89;55
33;33;2018-04-20 10:01:31.260;2018-04-20 11:36:09.387;95;34;89;55
33;33;2018-04-27 17:56:26.083;2018-04-30 02:56:09.987;3420;34;89;55
33;33;2018-05-02 08:11:31.690;2018-05-02 09:57:00.000;106;34;89;55
33;33;2018-05-21 06:29:19.880;2018-05-21 07:47:52.600;78;33;89;56
33;33;2018-05-19 00:31:06.053;2018-05-21 07:47:52.600;3316;31;89;58
41;41;2018-05-24 21:22:34.737;2018-05-24 22:47:16.120;85;32;89;57
41;41;2018-05-23 07:15:39.787;2018-05-23 10:38:14.033;203;34;89;55
41;41;2018-05-22 10:25:34.347;2018-05-22 13:37:20.723;192;34;89;55
41;41;2018-05-17 19:09:42.803;2018-05-18 13:05:47.320;1076;33;89;56
41;41;2018-05-16 21:04:31.810;2018-05-16 23:20:00.253;136;33;89;56
41;41;2018-05-16 03:05:05.697;2018-05-16 05:15:55.740;130;34;89;55
41;41;2018-05-02 07:20:03.407;2018-05-02 08:49:23.683;89;34;89;55
41;41;2018-04-30 13:49:00.767;2018-04-30 15:12:56.397;83;34;89;55
33;33;2018-02-20 20:55:53.680;2018-02-20 22:43:39.510;108;34;89;55
41;41;2018-04-25 02:42:38.747;2018-04-25 04:04:32.277;82;32;89;57
41;41;2018-04-02 06:23:07.813;2018-04-02 07:58:32.357;95;34;89;55
41;41;2018-03-27 09:33:54.670;2018-03-27 10:53:15.733;80;34;89;55
33;33;2018-02-16 12:51:16.710;2018-02-16 14:24:39.240;93;34;89;55
33;33;2018-02-16 12:56:58.463;2018-02-16 14:24:39.240;88;34;89;55
33;33;2018-02-02 20:13:57.620;2018-02-02 22:30:07.817;137;34;89;55
33;33;2018-02-01 13:52:31.267;2018-02-01 16:02:36.627;130;33;89;56
33;33;2018-01-31 16:51:53.620;2018-01-31 18:56:29.250;125;34;89;55
41;41;2018-03-14 12:51:38.380;2018-03-14 15:28:43.833;157;34;89;55
33;33;2018-01-29 07:57:37.607;2018-01-29 09:51:20.637;114;34;89;55
41;41;2018-03-13 17:31:01.037;2018-03-13 19:59:27.520;148;34;89;55
41;41;2018-02-03 05:11:00.743;2018-02-03 05:57:16.783;46;68;89;21
33;33;2018-01-26 06:24:36.383;2018-01-26 08:14:54.460;110;34;89;55
33;33;2018-01-24 07:00:02.403;2018-01-24 09:16:34.090;136;33;89;56
33;33;2018-01-24 07:27:38.440;2018-01-24 09:16:34.090;109;33;89;56
41;41;2018-01-31 18:49:00.907;2018-01-31 21:02:50.293;133;34;89;55
41;41;2018-01-26 07:40:37.920;2018-01-26 09:34:14.070;114;33;89;56
41;41;2018-01-28 21:55:13.657;2018-01-29 02:39:55.033;284;22;99;77
33;33;2018-01-19 06:36:40.160;2018-01-19 08:31:49.453;115;30;89;59
41;41;2018-04-10 06:10:51.293;2018-04-10 08:26:34.947;136;34;89;55
41;41;2018-03-09 18:15:50.720;2018-03-09 20:28:01.660;133;34;89;55
33;33;2018-01-15 11:06:51.237;2018-01-15 12:58:36.603;112;34;89;55
33;33;2018-01-11 19:41:57.343;2018-01-11 21:31:09.037;110;33;89;56
41;41;2018-03-09 03:50:03.040;2018-03-09 05:57:57.037;127;34;89;55
41;41;2018-03-07 06:21:04.010;2018-03-07 08:16:00.020;115;34;89;55
41;41;2018-02-05 14:46:49.780;2018-02-05 20:14:40.600;328;34;100;66
41;41;2018-02-05 14:49:27.063;2018-02-05 20:14:40.600;325;34;100;66
41;41;2018-02-03 11:00:57.757;2018-02-05 20:14:40.600;3434;83;100;17
41;41;2018-02-06 15:40:57.510;2018-02-06 17:27:29.057;107;34;89;55
41;41;2018-01-24 06:22:49.270;2018-01-24 08:06:32.363;104;33;89;56
41;41;2018-01-22 16:47:17.400;2018-01-22 18:26:02.027;99;34;89;55
41;41;2018-01-23 09:49:47.477;2018-01-23 11:36:14.427;107;34;89;55
41;41;2018-01-18 14:47:11.370;2018-01-18 16:56:49.240;129;34;89;55
41;41;2018-01-18 14:54:30.013;2018-01-18 16:56:49.240;122;34;89;55
41;41;2018-01-17 10:51:20.153;2018-01-17 13:45:34.060;174;34;89;55
41;41;2018-01-15 16:18:59.607;2018-01-15 17:39:11.830;81;47;89;42
41;41;2018-01-11 07:12:55.370;2018-01-11 09:03:45.617;111;33;89;56
41;41;2018-01-12 07:12:11.320;2018-01-12 08:57:30.540;105;33;89;56
33;33;2018-01-03 15:02:49.750;2018-01-03 16:30:21.410;88;33;75;42
33;33;2018-01-02 21:02:23.490;2018-01-02 22:48:26.373;106;32;89;57
41;41;2017-12-30 04:01:05.693;2017-12-30 09:12:32.453;311;44;100;56
33;33;2017-12-27 06:46:22.943;2017-12-27 08:29:27.343;103;33;89;56
41;41;2018-01-02 15:55:22.147;2018-01-02 17:44:10.337;109;34;89;55
41;41;2018-01-03 22:39:43.843;2018-01-04 00:39:35.377;120;34;89;55
41;41;2018-01-03 08:31:09.280;2018-01-03 10:19:47.397;108;33;89;56
41;41;2017-12-28 05:10:33.950;2017-12-28 07:22:06.357;132;31;89;58
41;41;2017-12-27 08:59:32.613;2017-12-27 11:14:39.660;135;34;89;55
41;41;2017-12-27 09:06:29.863;2017-12-27 11:14:39.660;128;34;89;55
41;41;2017-12-21 10:42:07.050;2017-12-21 13:33:42.677;171;36;89;53
33;33;2017-12-22 13:23:46.870;2017-12-22 15:11:35.163;108;33;89;56
33;33;2017-12-19 10:49:11.273;2017-12-19 13:13:57.380;144;34;89;55
41;41;2017-12-18 11:24:54.823;2017-12-18 13:13:40.667;109;34;89;55
41;41;2017-12-13 06:59:54.453;2017-12-13 09:18:28.180;139;34;89;55
41;41;2017-12-15 12:20:23.057;2017-12-15 15:00:00.047;160;33;93;60
41;41;2017-12-14 01:20:47.087;2017-12-14 03:45:44.840;145;34;89;55
41;41;2017-11-23 09:13:15.783;2017-11-23 10:20:48.290;67;34;83;49
41;41;2017-11-28 02:00:54.733;2017-11-28 03:52:57.573;112;32;89;57
41;41;2017-11-28 15:49:02.790;2017-11-28 17:25:18.407;96;34;83;49
33;33;2018-03-08 21:07:32.157;2018-03-08 22:28:57.350;81;33;89;56
33;33;2018-03-02 18:48:05.460;2018-03-02 20:14:45.517;86;32;89;57
41;41;2017-12-11 16:13:39.280;2017-12-11 18:35:40.533;142;34;89;55
33;33;2018-03-07 10:26:06.143;2018-03-07 11:44:46.707;78;34;89;55
41;41;2017-12-04 12:03:05.297;2017-12-04 13:46:48.213;103;34;89;55
41;41;2017-10-05 19:13:31.297;2017-10-05 20:29:28.090;76;34;89;55
33;33;2018-03-06 12:53:51.670;2018-03-06 14:12:28.417;79;35;89;54
41;41;2017-10-17 12:13:22.663;2017-10-17 14:23:06.183;130;33;89;56
41;41;2017-10-19 06:49:26.140;2017-10-19 08:10:03.963;81;34;85;51
41;41;2017-10-18 11:03:42.777;2017-10-18 13:17:05.333;134;34;89;55
41;41;2017-10-22 22:46:36.647;2017-10-23 03:36:55.510;290;8;100;92
41;41;2017-10-22 22:48:32.000;2017-10-23 03:36:55.510;288;8;100;92
41;41;2017-10-24 16:54:26.157;2017-10-25 01:19:41.950;505;33;89;56
41;41;2017-10-25 00:04:10.733;2017-10-25 01:19:41.950;75;33;89;56
33;33;2018-04-03 07:14:53.653;2018-04-03 09:31:28.670;137;34;89;55
33;33;2018-03-13 13:26:41.077;2018-03-13 14:50:48.693;84;33;89;56
41;41;2017-11-21 04:37:00.887;2017-11-21 05:46:33.433;69;33;89;56
33;33;2018-02-26 21:58:44.540;2018-02-26 23:03:08.340;65;41;89;48
41;41;2017-11-09 10:55:18.407;2017-11-09 11:55:44.270;60;33;78;45
33;33;2018-02-21 16:26:35.670;2018-02-21 18:05:48.217;99;34;89;55
33;33;2018-02-23 12:25:04.310;2018-02-23 13:50:07.603;85;34;89;55
33;33;2018-03-19 11:47:06.667;2018-03-19 13:19:45.877;92;34;89;55
33;33;2018-03-20 10:21:02.503;2018-03-20 11:56:16.123;95;34;89;55
33;33;2018-03-15 19:05:26.530;2018-03-15 20:32:58.913;87;34;89;55
33;33;2018-03-15 04:38:02.120;2018-03-15 06:05:13.557;87;33;89;56
33;33;2018-03-22 13:00:26.797;2018-03-22 14:40:28.873;100;34;89;55
33;33;2018-04-02 12:57:59.133;2018-04-02 15:15:57.473;138;34;89;55
33;33;2018-03-26 00:39:21.573;2018-03-26 02:41:11.743;122;31;89;58
33;33;2018-03-27 07:13:31.233;2018-03-27 09:05:19.483;112;31;89;58
33;33;2018-04-19 14:32:21.567;2018-04-19 16:05:31.783;93;34;89;55
33;33;2018-04-30 18:29:55.583;2018-04-30 19:53:33.660;84;33;89;56
33;33;2018-05-16 19:45:08.930;2018-05-16 21:01:01.320;76;34;89;55
33;33;2018-05-18 10:06:20.727;2018-05-18 10:58:55.413;52;34;73;39
33;33;2018-05-21 22:53:24.807;2018-05-22 00:13:56.550;80;33;89;56
33;33;2018-05-23 09:58:41.900;2018-05-23 11:18:45.597;80;34;89;55
33;33;2018-04-06 02:53:24.273;2018-04-06 05:31:04.853;158;34;89;55
33;33;2018-05-03 13:17:53.167;2018-05-03 14:49:57.983;92;34;89;55
33;33;2018-04-16 20:24:48.700;2018-04-16 21:52:17.680;88;34;89;55
33;33;2018-04-11 12:43:02.087;2018-04-11 14:00:04.220;77;33;89;56
33;33;2018-04-12 07:25:39.103;2018-04-12 08:44:06.250;79;33;89;56
33;33;2018-05-14 14:58:11.003;2018-05-14 16:16:04.033;78;32;89;57
33;33;2018-05-14 17:51:12.643;2018-05-14 17:54:06.630;3;87;89;2
33;33;2018-05-28 05:11:22.100;2018-05-28 06:38:53.813;87;31;89;58
33;33;2018-05-29 18:18:37.540;2018-05-29 19:45:15.583;87;34;89;55
33;33;2018-05-31 08:35:39.287;2018-05-31 09:49:00.067;74;34;89;55
33;33;2018-05-31 21:53:40.407;2018-05-31 23:05:35.440;72;34;89;55
33;33;2018-06-05 13:50:39.790;2018-06-05 15:01:36.057;71;34;89;55
33;33;2018-06-18 23:58:59.113;2018-06-19 01:34:57.753;96;34;89;55
33;33;2018-06-20 11:19:24.210;2018-06-20 13:03:00.867;104;34;89;55
41;41;2017-11-06 12:23:02.957;2017-11-07 12:06:33.983;1423;34;89;55
41;41;2017-11-06 12:36:26.777;2017-11-07 12:06:33.983;1410;34;89;55
41;41;2017-11-08 06:56:41.670;2017-11-08 15:13:02.500;497;34;89;55
41;41;2017-11-08 07:13:49.070;2017-11-08 15:13:02.500;480;34;89;55
41;41;2017-11-03 16:09:03.753;2017-11-03 17:47:46.920;98;34;89;55
41;41;2017-11-03 16:10:19.287;2017-11-03 17:47:46.920;97;34;89;55
41;41;2017-11-03 06:57:48.320;2017-11-03 17:47:46.920;650;34;89;55
41;41;2017-10-03 16:12:51.043;2017-10-03 16:37:14.373;25;34;51;17
41;41;2017-10-03 22:30:57.750;2017-10-03 23:40:09.063;70;34;89;55
41;41;2017-10-04 10:57:09.960;2017-10-04 12:10:00.570;73;34;89;55
33;33;2018-06-28 05:45:45.863;2018-06-28 07:02:15.230;77;34;89;55
41;41;2018-07-04 23:55:22.840;2018-07-05 01:19:09.683;84;34;89;55
41;41;2018-07-02 10:31:24.893;2018-07-02 14:37:42.710;246;33;100;67
41;41;2018-07-03 11:12:36.247;2018-07-03 12:33:26.010;81;33;89;56
41;41;2018-06-15 22:52:46.530;2018-06-16 00:25:57.350;93;32;89;57
41;41;2018-06-18 13:11:18.373;2018-06-18 14:43:54.027;92;34;89;55
41;41;2018-06-07 17:07:23.187;2018-06-07 18:27:36.037;80;34;89;55
41;41;2018-08-06 15:25:11.280;2018-08-06 17:24:28.650;119;30;89;59
41;41;2018-07-17 05:08:43.930;2018-07-17 06:26:36.957;78;34;89;55
41;41;2018-06-28 04:11:37.003;2018-06-28 08:47:23.537;276;34;99;65
41;41;2018-06-27 04:52:19.933;2018-06-27 05:45:31.730;53;34;66;32
41;41;2018-06-21 18:05:26.643;2018-06-21 20:13:49.127;128;34;93;59
41;41;2018-05-30 07:47:02.823;2018-05-30 09:28:28.400;101;34;89;55
41;41;2018-05-30 07:53:57.493;2018-05-30 09:28:28.400;95;34;89;55
41;41;2018-05-11 23:48:09.580;2018-05-12 01:45:10.733;117;33;89;56
41;41;2018-05-09 05:42:10.793;2018-05-09 07:22:54.940;100;33;89;56
41;41;2018-05-08 10:32:32.373;2018-05-08 12:10:49.507;98;34;89;55
41;41;2018-05-07 13:41:40.180;2018-05-07 15:18:58.930;97;34;89;55
41;41;2018-05-04 20:55:12.903;2018-05-04 22:27:50.033;92;34;89;55
41;41;2018-06-06 07:07:48.867;2018-06-06 08:26:36.160;79;34;89;55
41;41;2018-05-18 10:36:42.067;2018-05-18 13:05:47.320;149;33;89;56
41;41;2018-04-28 02:34:33.407;2018-04-28 03:56:54.800;82;34;89;55
41;41;2018-04-27 02:38:44.860;2018-04-27 04:00:50.017;82;34;89;55
41;41;2018-03-21 12:27:04.187;2018-03-21 13:50:57.453;83;34;89;55
41;41;2018-03-22 08:29:52.913;2018-03-22 09:50:37.693;81;34;89;55
33;33;2018-01-30 20:10:43.463;2018-01-30 22:13:01.533;123;34;89;55
33;33;2018-01-25 07:06:03.373;2018-01-25 08:58:23.663;112;34;89;55
33;33;2018-01-25 07:10:18.860;2018-01-25 08:58:23.663;108;34;89;55
41;41;2018-01-31 19:00:49.513;2018-01-31 21:02:50.293;122;34;89;55
33;33;2018-01-23 08:17:12.907;2018-01-23 10:03:40.620;106;34;89;55
33;33;2018-01-22 03:38:20.043;2018-01-22 09:38:05.040;360;31;100;69
33;33;2018-01-19 20:56:15.520;2018-01-19 21:51:06.523;55;56;89;33
33;33;2018-01-19 06:44:10.773;2018-01-19 08:31:49.453;107;30;89;59
33;33;2018-01-16 09:36:47.923;2018-01-16 09:38:08.780;2;88;89;1
41;41;2018-04-09 06:29:06.310;2018-04-09 08:31:38.970;122;33;89;56
33;33;2018-01-17 07:59:53.230;2018-01-17 10:02:32.400;123;34;89;55
41;41;2018-04-05 11:23:02.860;2018-04-05 13:12:04.520;109;34;89;55
41;41;2018-03-12 18:18:04.457;2018-03-12 20:36:57.403;138;34;89;55
41;41;2018-04-02 20:08:55.007;2018-04-02 21:49:09.900;101;31;89;58
41;41;2018-04-02 20:10:04.723;2018-04-02 21:49:09.900;99;31;89;58
41;41;2018-04-03 11:58:08.363;2018-04-03 13:38:39.577;100;34;89;55
33;33;2018-01-10 22:09:21.067;2018-01-10 23:59:18.007;110;33;89;56
41;41;2018-03-05 07:20:53.600;2018-03-05 09:27:12.417;127;34;89;55
41;41;2018-03-02 13:44:42.597;2018-03-02 15:32:19.007;108;31;89;58
41;41;2018-03-01 10:01:39.140;2018-03-01 11:40:47.737;99;34;89;55
41;41;2018-02-07 10:44:07.653;2018-02-07 12:31:45.860;107;33;89;56
41;41;2018-02-04 22:44:55.027;2018-02-05 20:14:40.600;1290;75;100;25
41;41;2018-01-19 20:55:59.253;2018-01-19 22:48:59.077;113;39;89;50
41;41;2018-01-17 11:46:35.810;2018-01-17 13:45:34.060;119;34;89;55
41;41;2018-01-17 10:43:15.680;2018-01-17 13:45:34.060;182;34;89;55
41;41;2018-01-11 07:11:36.033;2018-01-11 09:03:45.617;112;33;89;56
33;33;2018-01-04 22:33:25.820;2018-01-05 00:16:58.007;103;33;89;56
33;33;2018-01-03 14:59:21.613;2018-01-03 16:30:21.410;91;33;75;42
41;41;2018-01-06 01:44:15.190;2018-01-06 03:30:01.807;106;33;89;56
41;41;2018-01-02 02:52:46.973;2018-01-02 04:42:37.870;110;39;89;50
41;41;2017-12-28 22:17:41.553;2017-12-29 00:36:42.463;139;33;89;56
41;41;2017-12-27 09:15:21.590;2017-12-27 11:14:39.660;119;34;89;55
41;41;2017-12-21 11:42:57.977;2017-12-21 13:33:42.677;111;33;89;56
41;41;2017-12-26 08:46:23.070;2017-12-26 10:41:38.620;115;34;89;55
41;41;2017-12-22 08:48:10.310;2017-12-22 10:53:51.810;125;34;89;55
41;41;2017-12-19 15:20:46.930;2017-12-19 17:10:13.053;110;34;89;55
33;33;2017-12-22 13:22:05.887;2017-12-22 15:11:35.163;109;33;89;56
41;41;2017-12-16 04:01:31.297;2017-12-16 09:23:36.580;322;65;100;35
41;41;2017-12-16 04:32:32.263;2017-12-16 09:23:36.580;291;64;100;36
41;41;2017-12-19 01:30:39.770;2017-12-19 03:18:49.593;108;33;89;56
41;41;2017-12-12 10:41:40.247;2017-12-12 12:56:28.920;135;34;89;55
33;33;2017-12-20 07:00:33.810;2017-12-20 09:21:35.203;141;33;92;59
41;41;2017-11-27 08:18:40.403;2017-11-27 10:01:08.733;103;34;89;55
41;41;2017-12-09 17:09:18.973;2017-12-09 19:07:29.530;118;33;89;56
33;33;2018-03-08 04:52:50.250;2018-03-08 06:12:38.253;80;34;89;55
41;41;2017-12-02 04:01:42.150;2017-12-02 09:05:41.757;304;38;100;62
41;41;2017-10-09 16:50:40.750;2017-10-09 18:12:21.950;82;34;89;55
41;41;2017-10-10 08:41:55.083;2017-10-10 10:00:11.993;79;34;89;55
41;41;2017-10-16 16:58:48.453;2017-10-16 18:46:57.530;108;34;89;55
41;41;2017-10-13 14:02:51.430;2017-10-13 15:33:13.633;91;34;89;55
41;41;2017-10-17 12:16:51.870;2017-10-17 14:23:06.183;127;33;89;56
41;41;2017-10-17 12:19:02.497;2017-10-17 14:23:06.183;124;33;89;56
41;41;2017-10-19 06:48:28.370;2017-10-19 08:10:03.963;82;34;85;51
41;41;2017-10-22 22:34:27.710;2017-10-23 03:36:55.510;302;8;100;92
41;41;2017-10-22 22:47:31.907;2017-10-23 03:36:55.510;289;8;100;92
41;41;2017-10-22 22:49:28.030;2017-10-23 03:36:55.510;287;8;100;92
41;41;2017-10-23 18:31:42.260;2017-10-23 19:35:38.050;64;34;89;55
41;41;2017-10-24 16:38:01.907;2017-10-25 01:19:41.950;521;33;89;56
41;41;2017-10-24 16:47:12.997;2017-10-25 01:19:41.950;512;33;89;56
41;41;2017-10-24 17:05:34.110;2017-10-25 01:19:41.950;494;33;89;56
41;41;2017-10-31 14:51:41.720;2017-10-31 15:18:05.893;27;33;51;18
41;41;2017-10-31 20:22:43.857;2017-10-31 21:44:11.943;82;33;89;56
41;41;2017-11-20 12:36:31.170;2017-11-20 12:38:24.650;2;88;89;1
33;33;2018-03-14 09:27:20.850;2018-03-14 10:52:13.997;85;34;89;55
41;41;2017-11-20 11:33:15.187;2017-11-20 12:35:14.643;62;34;88;54
41;41;2017-11-22 14:49:21.540;2017-11-22 16:00:14.123;71;34;89;55
41;41;2017-11-21 21:26:31.883;2017-11-21 22:35:26.430;69;34;89;55
33;33;2018-02-21 16:28:05.270;2018-02-21 18:05:48.217;97;34;89;55
41;41;2017-11-10 01:04:12.177;2017-11-10 03:33:45.180;149;33;89;56
41;41;2017-11-06 12:35:35.867;2017-11-07 12:06:33.983;1411;34;89;55
33;33;2018-02-26 10:19:18.740;2018-02-26 11:31:16.510;72;34;89;55
33;33;2018-03-16 16:14:00.563;2018-03-16 17:44:05.140;90;33;89;56
33;33;2018-04-18 19:12:02.140;2018-04-18 20:39:16.520;87;34;89;55
33;33;2018-04-24 07:51:28.207;2018-04-24 09:31:18.583;100;33;89;56
33;33;2018-04-27 03:17:16.263;2018-04-27 04:37:06.240;80;34;89;55
33;33;2018-04-26 10:23:48.303;2018-04-26 11:41:52.393;78;33;89;56
33;33;2018-05-07 12:41:33.503;2018-05-07 14:15:55.927;94;34;89;55
33;33;2018-05-04 20:05:40.800;2018-05-04 21:37:55.610;92;32;89;57
33;33;2018-05-02 22:20:11.457;2018-05-02 23:48:16.473;88;33;89;56
33;33;2018-04-16 07:05:11.333;2018-04-16 08:24:49.657;79;34;88;54
33;33;2018-04-13 14:03:02.830;2018-04-13 15:23:48.393;80;34;89;55
33;33;2018-05-14 15:00:07.593;2018-05-14 16:16:04.033;76;32;89;57
33;33;2018-05-28 23:44:15.593;2018-05-29 01:09:32.603;85;34;89;55
33;33;2018-05-28 03:51:19.147;2018-05-28 06:38:53.813;167;31;89;58
33;33;2018-05-30 09:59:26.123;2018-05-30 11:28:11.197;89;34;92;58
33;33;2018-06-01 18:13:03.993;2018-06-01 19:23:04.720;70;34;89;55
33;33;2018-06-04 20:33:30.740;2018-06-04 22:13:38.757;100;34;89;55
33;33;2018-06-04 20:37:35.860;2018-06-04 22:13:38.757;96;34;89;55
33;33;2018-06-04 07:01:34.603;2018-06-04 08:22:10.693;81;33;89;56
33;33;2018-06-18 23:57:08.577;2018-06-19 01:34:57.753;97;34;89;55
41;41;2017-11-08 13:10:17.493;2017-11-08 15:13:02.500;123;34;89;55
41;41;2017-11-08 07:01:39.797;2017-11-08 15:13:02.500;492;34;89;55
41;41;2017-11-08 07:06:21.967;2017-11-08 15:13:02.500;487;34;89;55
41;41;2017-11-08 07:09:08.990;2017-11-08 15:13:02.500;484;34;89;55
41;41;2017-11-08 07:09:54.443;2017-11-08 15:13:02.500;484;34;89;55
41;41;2017-11-08 07:10:49.753;2017-11-08 15:13:02.500;483;34;89;55
41;41;2017-10-02 19:13:29.253;2017-10-02 20:50:21.127;97;33;95;62
33;33;2018-06-21 10:30:50.023;2018-06-21 12:17:19.133;107;34;89;55
33;33;2018-06-26 13:31:20.120;2018-06-26 15:14:09.550;103;34;92;58
33;33;2018-06-25 17:03:43.303;2018-06-25 19:04:08.200;121;33;89;56
33;33;2018-07-02 07:41:53.923;2018-07-02 08:57:06.483;76;34;89;55
33;33;2018-07-17 18:03:31.623;2018-07-17 20:40:31.037;157;33;100;67
33;33;2018-07-20 11:11:59.810;2018-07-20 12:42:00.187;91;33;89;56
41;41;2018-05-29 20:29:47.600;2018-05-30 09:28:28.400;779;34;89;55
41;41;2018-05-30 07:52:32.267;2018-05-30 09:28:28.400;96;34;89;55
41;41;2018-05-14 13:45:32.887;2018-05-14 15:55:13.170;130;34;89;55
41;41;2018-05-04 02:49:11.620;2018-05-04 04:20:27.390;91;34;89;55
41;41;2018-05-04 02:50:49.857;2018-05-04 04:20:27.390;90;34;89;55
41;41;2018-04-26 09:53:37.530;2018-04-26 11:14:19.297;81;34;89;55
33;33;2018-02-20 21:02:25.030;2018-02-20 22:43:39.510;101;34;89;55
33;33;2018-02-20 21:08:12.837;2018-02-20 22:43:39.510;95;34;89;55
41;41;2018-03-28 15:47:25.010;2018-03-28 17:15:21.697;88;32;89;57
41;41;2018-03-24 11:41:43.750;2018-03-24 16:33:35.530;292;38;100;62
41;41;2018-03-23 06:54:06.807;2018-03-23 08:17:08.340;83;34;89;55
41;41;2018-03-20 22:56:43.867;2018-03-21 00:18:39.210;82;33;89;56
41;41;2018-03-20 06:51:00.437;2018-03-20 08:09:41.310;78;34;89;55
33;33;2018-01-30 20:11:56.037;2018-01-30 22:13:01.533;122;34;89;55
33;33;2018-01-30 03:04:09.053;2018-01-30 05:05:41.630;121;34;89;55
33;33;2018-01-26 06:25:46.070;2018-01-26 08:14:54.460;109;34;89;55
41;41;2018-01-29 21:27:33.387;2018-01-30 01:40:26.413;253;34;100;66
41;41;2018-01-29 21:28:50.703;2018-01-30 01:40:26.413;252;34;100;66
33;33;2018-01-18 08:05:41.293;2018-01-18 09:47:55.220;102;33;89;56
33;33;2018-01-18 08:10:40.090;2018-01-18 09:47:55.220;97;33;89;56
33;33;2018-01-16 07:44:20.477;2018-01-16 09:35:31.750;111;34;88;54
41;41;2018-04-06 08:07:22.353;2018-04-06 10:03:23.080;116;33;89;56
33;33;2018-01-17 08:01:55.830;2018-01-17 10:02:32.400;121;34;89;55
41;41;2018-04-04 09:39:12.773;2018-04-04 11:20:56.297;101;34;89;55
41;41;2018-03-12 18:14:31.110;2018-03-12 20:36:57.403;142;34;89;55
33;33;2018-01-09 08:59:36.017;2018-01-09 10:51:24.463;112;34;89;55
41;41;2018-02-12 07:38:10.547;2018-02-12 09:05:42.353;87;30;89;59
41;41;2018-01-25 05:08:18.827;2018-01-25 06:57:48.800;109;33;89;56
41;41;2018-01-17 11:49:45.267;2018-01-17 13:45:34.060;116;34;89;55
41;41;2018-01-17 10:49:52.893;2018-01-17 13:45:34.060;176;34;89;55
41;41;2018-01-15 06:37:08.607;2018-01-15 08:23:22.273;106;34;89;55
41;41;2018-01-10 07:54:59.810;2018-01-10 09:41:18.067;107;33;89;56
41;41;2018-01-09 14:07:08.490;2018-01-09 15:50:06.997;103;34;89;55
41;41;2018-01-06 01:39:35.453;2018-01-06 03:30:01.807;111;33;89;56
33;33;2018-01-03 15:01:32.743;2018-01-03 16:30:21.410;89;33;75;42
33;33;2018-01-04 03:14:27.140;2018-01-04 04:44:29.820;90;42;89;47
33;33;2018-01-02 10:18:24.810;2018-01-02 11:31:03.187;73;31;68;37
33;33;2017-12-28 10:46:28.277;2018-01-02 11:31:03.187;7245;31;68;37
41;41;2018-01-04 17:15:58.903;2018-01-04 19:07:36.927;112;33;92;59
41;41;2017-12-27 03:55:40.167;2017-12-27 11:14:39.660;439;34;89;55
41;41;2017-12-22 09:02:03.887;2017-12-22 10:53:51.810;111;34;89;55
33;33;2017-12-26 17:28:18.053;2017-12-27 08:29:27.343;901;59;89;30
33;33;2017-12-21 20:06:07.433;2017-12-21 21:50:10.663;104;33;89;56
33;33;2017-12-19 10:43:46.403;2017-12-19 13:13:57.380;150;34;89;55
41;41;2017-12-18 10:43:05.570;2017-12-18 13:13:40.667;150;34;89;55
41;41;2017-12-14 17:29:42.233;2017-12-14 19:58:27.057;149;34;89;55
41;41;2017-11-24 12:00:56.350;2017-11-24 14:10:06.930;130;30;89;59
33;33;2018-03-02 18:49:26.550;2018-03-02 20:14:45.517;85;32;89;57
41;41;2017-10-08 23:25:04.163;2017-10-09 00:41:53.993;76;33;89;56
41;41;2017-10-11 04:39:20.560;2017-10-11 06:00:46.863;81;34;89;55
41;41;2017-10-11 19:50:58.473;2017-10-11 21:15:11.140;85;34;89;55
41;41;2017-10-16 04:21:56.900;2017-10-16 06:15:52.317;114;26;89;63
41;41;2017-10-20 05:42:16.573;2017-10-20 06:42:55.053;60;34;89;55
41;41;2017-10-22 23:00:41.723;2017-10-23 03:36:55.510;276;8;100;92
41;41;2017-11-16 16:43:46.863;2017-11-16 17:55:29.390;72;34;89;55
41;41;2017-11-14 11:40:56.907;2017-11-14 12:48:28.420;68;33;89;56
33;33;2018-04-04 07:58:25.417;2018-04-04 10:21:53.313;143;34;89;55
33;33;2018-02-27 14:39:54.693;2018-02-27 15:53:33.850;74;33;89;56
41;41;2017-11-18 07:09:56.410;2017-11-18 11:38:43.353;269;56;100;44
41;41;2017-11-09 11:55:50.010;2017-11-10 03:33:45.180;938;78;89;11
33;33;2018-03-21 03:32:18.013;2018-03-21 05:09:02.230;97;33;89;56
33;33;2018-04-17 13:31:27.923;2018-04-17 14:59:06.547;88;34;89;55
33;33;2018-03-23 08:03:28.503;2018-03-23 09:30:18.347;87;33;86;53
33;33;2018-04-20 09:11:40.787;2018-04-20 11:36:09.387;145;34;89;55
33;33;2018-04-24 20:34:52.860;2018-04-24 22:17:16.300;103;34;89;55
33;33;2018-04-30 01:33:51.720;2018-04-30 02:56:09.987;83;33;89;56
33;33;2018-05-16 04:59:13.400;2018-05-16 06:19:49.500;80;31;89;58
33;33;2018-05-17 13:04:17.460;2018-05-17 14:25:03.723;81;33;89;56
33;33;2018-05-19 03:00:10.657;2018-05-21 07:47:52.600;3167;46;89;43
33;33;2018-05-22 15:20:19.440;2018-05-22 16:59:55.760;99;33;89;56
33;33;2018-04-09 05:03:13.883;2018-04-09 07:55:20.607;172;33;89;56
33;33;2018-05-09 14:55:52.583;2018-05-09 16:38:46.770;103;34;89;55
33;33;2018-05-08 22:31:26.513;2018-05-09 00:08:39.757;97;34;89;55
33;33;2018-05-11 06:22:26.730;2018-05-11 07:36:30.527;74;33;89;56
33;33;2018-05-28 23:15:30.720;2018-05-29 01:09:32.603;114;34;89;55
33;33;2018-05-15 08:33:44.853;2018-05-15 09:50:53.890;77;33;89;56
33;33;2018-06-04 20:40:19.000;2018-06-04 22:13:38.757;93;34;89;55
41;41;2017-11-13 21:44:52.383;2017-11-13 22:51:08.557;67;33;89;56
41;41;2017-11-07 10:18:02.123;2017-11-07 12:06:33.983;108;34;89;55
41;41;2017-11-06 12:32:21.753;2017-11-07 12:06:33.983;1414;34;89;55
41;41;2017-11-08 12:14:54.620;2017-11-08 15:13:02.500;179;34;89;55
41;41;2017-11-08 12:16:54.200;2017-11-08 15:13:02.500;177;34;89;55
41;41;2017-11-08 12:18:00.477;2017-11-08 15:13:02.500;175;34;89;55
41;41;2017-11-08 07:14:53.953;2017-11-08 15:13:02.500;479;34;89;55
41;41;2017-11-08 07:02:59.480;2017-11-08 15:13:02.500;491;34;89;55
41;41;2017-10-02 18:38:46.510;2017-10-02 20:50:21.127;132;33;95;62
33;33;2018-06-19 17:42:32.623;2018-06-19 19:20:38.410;98;34;89;55
33;33;2018-06-22 07:37:34.770;2018-06-22 09:29:17.793;112;34;89;55
33;33;2018-06-25 10:40:42.687;2018-06-25 19:04:08.200;504;34;89;55
33;33;2018-07-12 13:10:56.243;2018-07-12 15:09:37.490;119;34;89;55
33;33;2018-07-13 22:18:30.210;2018-07-13 23:44:55.423;86;34;89;55
33;33;2018-07-17 18:00:59.617;2018-07-17 20:40:31.037;160;33;100;67
33;33;2018-07-31 09:27:07.503;2018-07-31 10:41:17.243;74;32;89;57
33;33;2018-08-03 03:45:39.350;2018-08-03 04:56:55.970;71;33;88;55
33;33;2018-08-06 07:52:27.840;2018-08-06 09:04:02.830;72;33;89;56
33;33;2018-08-15 22:16:00.090;2018-08-16 08:35:09.567;619;31;89;58
33;33;2018-08-16 06:41:52.257;2018-08-16 08:35:09.567;114;21;89;68
33;33;2018-08-16 06:41:54.073;2018-08-16 08:35:09.567;114;20;89;69
33;33;2018-08-16 06:42:01.637;2018-08-16 08:35:09.567;113;20;89;69
33;33;2018-08-16 06:42:09.420;2018-08-16 08:35:09.567;113;20;89;69
33;33;2018-08-23 18:08:59.933;2018-08-23 19:37:21.417;89;34;89;55
33;33;2018-08-24 12:52:22.827;2018-08-24 14:16:22.870;84;34;89;55
33;33;2018-08-27 04:01:14.520;2018-08-27 05:28:02.603;87;33;89;56
33;33;2018-09-11 23:49:35.907;2018-09-12 01:06:16.053;77;33;89;56
33;33;2018-09-18 16:31:05.190;2018-09-18 17:48:55.433;77;33;85;52
33;33;2018-09-20 06:24:09.347;2018-09-20 07:51:12.573;87;34;89;55
33;33;2018-09-26 14:45:42.980;2018-09-26 16:17:24.837;92;34;89;55
33;33;2018-05-24 09:39:32.823;2018-05-24 11:02:11.607;83;34;89;55
33;33;2018-06-06 21:25:42.070;2018-06-06 22:47:25.693;82;32;89;57
33;33;2018-06-06 21:32:27.720;2018-06-06 22:47:25.693;75;32;89;57
33;33;2018-06-07 14:33:16.737;2018-06-07 18:37:09.927;244;28;89;61
33;33;2018-06-07 17:08:55.780;2018-06-07 18:37:09.927;89;28;89;61
33;33;2018-06-12 17:00:02.033;2018-06-12 18:21:07.767;81;34;89;55
33;33;2018-06-18 09:00:09.313;2018-06-18 10:33:16.183;93;34;89;55
33;33;2018-06-14 20:09:38.997;2018-06-14 21:35:13.833;86;33;89;56
33;33;2018-07-23 04:00:48.230;2018-07-23 05:21:15.773;81;33;89;56
33;33;2018-07-25 11:18:02.503;2018-07-25 11:59:17.737;41;60;89;29
33;33;2018-07-27 17:25:44.783;2018-07-27 19:02:35.037;97;33;89;56
33;33;2018-07-27 17:28:50.570;2018-07-27 19:02:35.037;94;33;89;56
33;33;2018-07-26 21:34:17.410;2018-07-27 00:28:13.747;174;34;89;55
33;33;2018-08-08 03:35:57.460;2018-08-08 04:49:33.773;74;34;89;55
33;33;2018-08-27 17:18:18.460;2018-08-27 18:47:04.750;89;33;89;56
33;33;2018-08-29 06:42:22.887;2018-08-29 09:59:08.687;197;33;89;56
33;33;2018-08-29 22:48:06.547;2018-08-30 00:00:17.520;72;33;89;56
33;33;2018-08-31 03:51:45.843;2018-08-31 05:04:05.200;73;34;89;55
33;33;2018-08-31 19:02:42.233;2018-08-31 20:15:47.417;73;34;89;55
33;33;2018-09-03 12:02:26.750;2018-09-03 12:31:45.200;29;34;56;22
33;33;2018-05-08 07:53:46.090;2018-05-08 09:29:30.413;96;34;89;55
33;33;2018-04-09 21:27:44.330;2018-04-10 00:15:05.407;168;34;89;55
33;33;2018-04-10 20:37:47.170;2018-04-10 21:54:35.813;77;34;89;55
33;33;2018-04-12 21:38:13.653;2018-04-12 22:57:40.630;79;34;89;55
33;33;2018-05-10 12:07:58.857;2018-05-10 13:27:25.323;80;34;89;55
33;33;2018-05-11 23:39:16.180;2018-05-12 00:53:12.347;74;34;89;55
33;33;2018-05-14 14:51:57.277;2018-05-14 16:16:04.033;85;32;89;57
33;33;2018-05-14 14:56:40.657;2018-05-14 16:16:04.033;80;32;89;57
33;33;2018-05-28 23:30:10.973;2018-05-29 01:09:32.603;99;34;89;55
33;33;2018-05-28 23:31:41.753;2018-05-29 01:09:32.603;98;34;89;55
33;33;2018-05-28 23:34:41.160;2018-05-29 01:09:32.603;95;34;89;55
33;33;2018-05-28 23:43:21.843;2018-05-29 01:09:32.603;86;34;89;55
33;33;2018-06-04 20:21:10.020;2018-06-04 22:13:38.757;112;34;89;55
33;33;2018-06-04 20:31:23.993;2018-06-04 22:13:38.757;102;34;89;55
41;41;2017-11-08 07:05:01.020;2017-11-08 15:13:02.500;488;34;89;55
41;41;2017-11-08 07:07:14.530;2017-11-08 15:13:02.500;486;34;89;55
41;41;2017-11-03 07:01:30.480;2017-11-03 17:47:46.920;646;34;89;55
41;41;2017-10-03 16:18:26.810;2017-10-03 16:37:14.373;19;34;51;17
41;41;2017-10-05 03:50:26.533;2017-10-05 05:03:21.990;73;34;89;55
33;33;2018-06-25 17:05:37.543;2018-06-25 19:04:08.200;119;33;89;56
33;33;2018-06-27 11:18:49.090;2018-06-27 12:33:41.380;75;33;89;56
33;33;2018-07-20 11:08:12.437;2018-07-20 12:42:00.187;94;33;89;56
33;33;2018-08-01 00:34:54.890;2018-08-01 01:47:17.300;73;33;89;56
33;33;2018-07-31 09:04:52.667;2018-07-31 10:41:17.243;97;32;89;57
33;33;2018-08-16 06:42:00.350;2018-08-16 08:35:09.567;113;20;89;69
33;33;2018-08-16 06:42:08.450;2018-08-16 08:35:09.567;113;20;89;69
33;33;2018-08-16 06:42:13.027;2018-08-16 08:35:09.567;113;20;89;69
33;33;2018-08-16 06:42:39.300;2018-08-16 08:35:09.567;113;20;89;69
33;33;2018-08-16 09:00:36.407;2018-08-17 04:51:19.273;1191;88;89;1
33;33;2018-08-22 07:58:19.673;2018-08-22 09:22:14.380;84;33;89;56
33;33;2018-08-23 18:15:18.570;2018-08-23 19:37:21.417;82;34;89;55
33;33;2018-09-11 03:32:35.323;2018-09-11 03:52:39.440;20;34;46;12
33;33;2018-09-12 14:58:14.083;2018-09-12 16:16:46.773;78;34;89;55
33;33;2018-09-18 09:32:21.330;2018-09-18 10:21:03.403;49;33;63;30
33;33;2018-06-14 04:12:29.323;2018-06-14 05:37:44.177;85;33;89;56
33;33;2018-06-13 10:55:37.280;2018-06-13 12:18:16.387;83;34;89;55
33;33;2018-07-02 22:08:43.900;2018-07-02 23:26:20.500;78;33;89;56
33;33;2018-07-05 07:49:21.813;2018-07-05 09:10:29.080;81;33;89;56
33;33;2018-07-06 17:58:09.810;2018-07-06 19:29:21.380;91;33;89;56
33;33;2018-07-10 22:55:04.450;2018-07-11 00:38:03.440;103;34;89;55
33;33;2018-07-24 08:20:37.407;2018-07-24 08:58:25.057;38;34;60;26
33;33;2018-07-23 16:50:39.787;2018-07-23 18:22:22.803;92;34;89;55
33;33;2018-07-25 10:37:18.910;2018-07-25 11:16:03.563;39;33;60;27
33;33;2018-07-26 05:52:19.043;2018-07-26 07:11:59.560;79;33;89;56
33;33;2018-07-27 17:03:55.347;2018-07-27 19:02:35.037;119;33;89;56
33;33;2018-07-30 12:04:50.870;2018-07-30 13:33:24.860;89;34;89;55
33;33;2018-08-13 13:53:39.897;2018-08-13 15:09:16.987;76;34;89;55
33;33;2018-08-14 08:30:23.657;2018-08-14 09:48:19.663;78;33;89;56
33;33;2018-08-28 10:59:30.413;2018-08-28 12:26:58.830;87;33;89;56
33;33;2018-08-29 06:51:29.707;2018-08-29 09:59:08.687;188;33;89;56
33;33;2018-08-30 14:15:00.920;2018-08-30 15:28:25.757;73;33;89;56
33;33;2018-09-04 13:22:45.373;2018-09-04 14:38:44.280;76;33;89;56
33;33;2018-09-03 13:22:36.083;2018-09-03 14:08:04.967;46;54;89;35
37;37;2017-10-02 00:30:37.890;2017-10-02 00:30:38.993;0;99;100;1
37;37;2017-10-02 00:31:05.917;2017-10-02 00:31:06.997;0;99;100;1
37;37;2017-10-02 00:31:55.043;2017-10-02 00:31:56.017;0;99;100;1
37;37;2017-10-02 00:32:12.990;2017-10-02 00:32:14.067;0;99;100;1
42;42;2017-10-25 09:23:32.643;2017-10-25 11:17:26.190;114;34;87;53
42;42;2017-10-25 09:25:30.060;2017-10-25 11:17:26.190;112;34;87;53
42;42;2017-10-31 12:31:31.413;2017-10-31 13:20:23.757;49;34;74;40
42;42;2017-11-15 16:27:16.967;2017-11-15 17:41:06.747;74;33;89;56
42;42;2017-11-20 09:23:47.037;2017-11-20 12:27:22.213;184;34;85;51
42;42;2017-11-21 02:57:54.530;2017-11-21 06:15:20.633;198;33;92;59
42;42;2017-11-29 05:57:43.243;2017-11-29 07:48:38.027;111;34;89;55
42;42;2017-12-09 06:04:50.693;2017-12-09 06:57:50.723;53;92;100;8
42;42;2017-12-13 09:02:41.890;2017-12-13 11:23:29.170;141;34;89;55
42;42;2017-12-14 02:14:39.333;2017-12-14 05:01:19.937;167;34;89;55
42;42;2017-12-14 18:48:37.827;2017-12-14 22:54:18.663;246;33;89;56
42;42;2017-12-21 09:21:41.083;2017-12-21 11:37:49.553;136;34;91;57
42;42;2017-12-20 12:27:29.390;2017-12-20 15:04:31.140;157;34;89;55
42;42;2017-12-26 10:08:12.360;2017-12-26 11:55:43.097;107;34;89;55
42;42;2017-12-26 10:09:05.323;2017-12-26 11:55:43.097;106;34;89;55
42;42;2017-12-22 08:07:21.690;2017-12-22 09:57:16.687;110;34;89;55
42;42;2018-01-03 14:25:30.043;2018-01-03 16:16:48.527;111;34;85;51
42;42;2018-01-03 14:28:06.960;2018-01-03 16:16:48.527;108;34;85;51
42;42;2018-01-05 07:40:35.030;2018-01-05 09:33:08.990;113;33;89;56
42;42;2018-01-08 06:43:39.187;2018-01-08 09:01:48.407;138;34;89;55
42;42;2018-01-09 05:26:38.470;2018-01-09 09:43:07.447;257;34;88;54
42;42;2018-01-12 03:21:39.530;2018-01-12 05:51:53.950;150;33;89;56
42;42;2018-01-12 03:26:35.630;2018-01-12 05:51:53.950;145;33;89;56
42;42;2018-01-10 22:55:04.897;2018-01-11 00:56:30.167;121;33;89;56
42;42;2018-01-16 07:40:28.710;2018-01-16 09:35:11.267;115;34;87;53
42;42;2018-01-19 18:04:21.033;2018-01-19 21:36:42.637;212;33;89;56
42;42;2018-01-19 19:31:11.593;2018-01-19 21:36:42.637;125;33;89;56
42;42;2018-01-22 10:00:04.150;2018-01-23 15:37:13.357;1777;99;100;1
42;42;2018-01-23 10:23:31.210;2018-01-23 15:37:13.357;314;33;100;67
42;42;2018-01-29 22:23:13.833;2018-01-30 01:12:36.230;169;33;89;56
42;42;2018-02-01 23:38:24.800;2018-02-02 09:32:10.177;594;45;89;44
42;42;2018-02-18 22:21:32.667;2018-02-19 02:04:54.677;223;33;89;56
42;42;2018-02-21 21:08:19.897;2018-02-21 22:37:22.783;89;34;89;55
42;42;2018-02-22 17:13:13.373;2018-02-22 18:37:05.023;84;33;89;56
42;42;2018-02-26 10:31:40.440;2018-02-26 11:53:31.690;82;33;89;56
42;42;2018-02-27 06:55:08.593;2018-02-27 18:47:12.500;712;84;89;5
42;42;2018-02-27 01:03:19.377;2018-02-27 02:27:31.137;84;33;89;56
42;42;2018-02-23 15:16:56.173;2018-02-23 16:40:00.050;84;34;89;55
42;42;2018-03-19 10:27:16.173;2018-03-19 12:58:14.943;151;34;89;55
42;42;2018-03-20 09:32:36.677;2018-03-20 13:55:34.493;263;33;91;58
42;42;2018-03-26 00:38:31.417;2018-03-26 05:10:19.360;272;41;100;59
42;42;2018-03-22 21:27:43.083;2018-03-22 22:51:45.933;84;34;89;55
42;42;2018-02-06 11:16:51.090;2018-02-06 13:46:28.190;150;33;89;56
42;42;2018-02-06 11:20:14.770;2018-02-06 13:46:28.190;146;33;89;56
42;42;2018-02-06 11:28:44.657;2018-02-06 13:46:28.190;138;33;89;56
42;42;2018-02-07 11:42:11.140;2018-02-07 14:50:20.867;188;34;89;55
42;42;2018-02-12 20:37:12.540;2018-02-12 22:00:48.833;83;34;89;55
42;42;2018-02-13 14:56:20.850;2018-02-13 16:16:13.950;80;34;89;55
42;42;2018-02-14 11:03:54.803;2018-02-14 12:42:30.770;99;34;89;55
42;42;2018-02-28 11:21:04.443;2018-02-28 12:47:17.677;86;34;89;55
42;42;2018-03-03 13:02:27.327;2018-03-06 01:33:23.313;3631;52;100;48
42;42;2018-03-05 20:49:14.533;2018-03-06 01:33:23.313;284;34;100;66
42;42;2018-06-06 09:24:41.760;2018-06-06 11:27:17.690;123;33;51;18
42;42;2018-06-06 09:27:32.690;2018-06-06 11:27:17.690;120;33;51;18
42;42;2018-06-06 15:59:23.527;2018-06-06 17:57:56.550;118;34;74;40
42;42;2018-06-07 11:44:22.247;2018-06-07 13:23:23.337;99;34;92;58
42;42;2018-06-11 15:30:04.180;2018-06-11 16:47:23.083;77;33;89;56
42;42;2018-06-13 01:34:29.363;2018-06-13 02:44:39.407;70;33;81;48
42;42;2018-06-13 02:45:12.560;2018-06-13 02:58:28.190;13;81;89;8
42;42;2018-06-14 12:42:21.690;2018-06-14 14:09:38.097;87;33;89;56
42;42;2018-07-02 18:27:40.477;2018-07-03 13:38:41.647;1151;34;93;59
42;42;2018-07-05 00:26:55.437;2018-07-05 02:27:12.507;121;33;89;56
42;42;2018-07-07 01:10:08.520;2018-07-07 02:51:32.900;101;34;89;55
42;42;2018-07-11 09:33:51.690;2018-07-11 11:09:43.997;96;34;89;55
42;42;2018-07-10 13:53:51.597;2018-07-10 15:35:07.593;102;33;89;56
42;42;2018-07-10 14:07:47.000;2018-07-10 15:35:07.593;88;33;89;56
42;42;2018-05-29 13:35:13.090;2018-05-29 15:09:35.520;94;34;89;55
42;42;2018-06-05 07:32:37.063;2018-06-05 09:04:43.773;92;34;89;55
42;42;2018-06-19 12:45:51.323;2018-06-19 14:10:23.250;85;34;89;55
42;42;2018-06-26 22:22:44.320;2018-06-26 23:59:30.717;97;34;82;48
33;33;2018-08-01 16:20:29.513;2018-08-01 17:31:23.763;71;34;89;55
33;33;2018-08-02 10:59:37.040;2018-08-02 12:11:52.340;72;34;89;55
33;33;2018-08-16 06:41:56.303;2018-08-16 08:35:09.567;114;20;89;69
33;33;2018-08-16 06:41:58.447;2018-08-16 08:35:09.567;114;20;89;69
33;33;2018-08-16 06:42:11.600;2018-08-16 08:35:09.567;113;20;89;69
33;33;2018-08-06 22:15:55.510;2018-08-06 23:28:37.763;73;34;89;55
33;33;2018-08-18 01:35:53.093;2018-08-18 03:01:25.623;86;32;89;57
33;33;2018-08-21 11:20:26.610;2018-08-21 12:42:27.043;82;33;89;56
33;33;2018-08-23 17:57:27.987;2018-08-23 19:37:21.417;100;34;89;55
33;33;2018-09-08 02:40:23.653;2018-09-10 13:46:40.103;3546;32;89;57
33;33;2018-09-13 09:32:29.517;2018-09-13 12:07:36.407;155;37;89;52
33;33;2018-09-15 09:53:26.503;2018-09-15 11:14:13.857;81;32;89;57
33;33;2018-09-19 11:22:54.650;2018-09-19 13:23:15.133;121;34;89;55
33;33;2018-09-28 07:55:11.007;2018-09-28 09:32:42.407;97;34;89;55
33;33;2018-06-06 06:51:20.057;2018-06-06 08:18:04.613;87;33;89;56
33;33;2018-06-06 07:03:19.453;2018-06-06 08:18:04.613;75;33;89;56
33;33;2018-06-06 21:23:12.830;2018-06-06 22:47:25.693;84;32;89;57
33;33;2018-06-07 17:11:51.423;2018-06-07 18:37:09.927;86;28;89;61
33;33;2018-06-10 22:32:01.930;2018-06-11 01:33:19.963;181;18;99;81
33;33;2018-06-11 18:00:18.610;2018-06-11 23:42:33.250;342;34;100;66
33;33;2018-06-15 15:01:13.540;2018-06-15 16:29:43.047;88;34;89;55
33;33;2018-07-04 12:44:59.260;2018-07-04 14:03:24.990;79;34;89;55
33;33;2018-07-03 18:51:59.947;2018-07-03 20:09:40.490;78;33;89;56
33;33;2018-07-10 09:00:03.940;2018-07-10 10:23:30.187;83;34;89;55
33;33;2018-07-11 14:33:11.820;2018-07-11 16:04:07.797;91;33;89;56
33;33;2018-08-09 10:21:57.450;2018-08-09 11:38:52.517;77;34;89;55
33;33;2018-08-10 01:09:56.157;2018-08-10 02:26:04.317;77;34;89;55
33;33;2018-08-10 16:07:51.977;2018-08-10 17:25:38.637;78;33;89;56
33;33;2018-08-13 11:42:35.440;2018-08-13 15:09:16.987;207;33;89;56
33;33;2018-08-28 10:57:54.107;2018-08-28 12:26:58.830;89;33;89;56
33;33;2018-08-29 10:20:41.387;2018-08-29 10:21:46.317;1;88;89;1
33;33;2018-09-05 05:38:54.527;2018-09-05 06:54:47.803;76;31;89;58
33;33;2018-09-06 03:39:46.860;2018-09-06 04:56:00.070;77;33;89;56
37;37;2017-10-02 00:30:45.933;2017-10-02 00:30:46.983;0;99;100;1
37;37;2017-10-02 00:30:53.970;2017-10-02 00:30:54.963;0;99;100;1
37;37;2017-10-02 00:32:04.097;2017-10-02 00:32:05.007;0;99;100;1
37;37;2017-10-02 00:32:07.990;2017-10-02 00:32:09.010;0;99;100;1
42;42;2017-10-23 20:58:37.063;2017-10-23 22:31:45.933;93;33;89;56
42;42;2017-10-26 07:00:58.270;2017-10-26 09:37:59.080;157;34;93;59
42;42;2017-10-26 07:03:58.530;2017-10-26 09:37:59.080;154;34;93;59
42;42;2017-10-25 09:18:51.190;2017-10-25 11:17:26.190;119;34;87;53
42;42;2017-10-27 04:29:46.720;2017-10-27 05:36:02.410;67;34;89;55
42;42;2017-10-30 21:35:31.353;2017-10-30 23:08:55.770;93;34;89;55
42;42;2017-10-30 21:41:53.567;2017-10-30 23:08:55.770;87;34;89;55
42;42;2017-10-30 09:36:29.163;2017-10-30 10:41:39.740;65;34;89;55
42;42;2017-11-01 22:00:51.853;2017-11-01 23:37:48.153;97;29;89;60
42;42;2017-11-07 08:16:03.987;2017-11-07 09:25:27.960;69;34;89;55
42;42;2017-11-16 10:27:10.337;2017-11-16 10:39:52.637;12;34;37;3
42;42;2017-11-21 21:23:30.053;2017-11-21 22:29:09.973;66;34;89;55
42;42;2017-11-24 09:45:36.613;2017-11-24 10:05:22.507;20;34;46;12
42;42;2017-11-23 10:21:34.007;2017-11-23 11:19:36.720;58;38;89;51
42;42;2017-11-27 20:42:32.120;2017-11-27 22:37:39.477;115;34;89;55
42;42;2017-12-05 02:43:32.367;2017-12-05 04:40:59.040;117;34;89;55
42;42;2017-12-11 17:11:10.263;2017-12-11 19:00:13.233;109;33;89;56
42;42;2017-12-12 10:45:37.610;2017-12-12 12:37:23.220;112;33;89;56
42;42;2017-12-15 19:50:50.833;2017-12-15 22:28:05.073;158;34;89;55
42;42;2017-12-16 06:01:33.807;2017-12-16 08:52:47.607;171;76;100;24
42;42;2017-12-18 10:34:43.190;2017-12-18 12:18:56.770;104;34;89;55
42;42;2017-12-20 12:23:11.083;2017-12-20 15:04:31.140;161;34;89;55
42;42;2017-12-20 12:34:10.327;2017-12-20 15:04:31.140;150;34;89;55
42;42;2017-12-27 03:52:45.997;2017-12-27 06:55:37.880;183;33;89;56
42;42;2017-12-27 04:02:12.540;2017-12-27 06:55:37.880;173;33;89;56
42;42;2017-12-27 04:03:24.257;2017-12-27 06:55:37.880;172;33;89;56
42;42;2017-12-27 04:04:50.027;2017-12-27 06:55:37.880;171;33;89;56
42;42;2017-12-27 20:58:35.047;2017-12-27 22:52:37.797;114;33;89;56
42;42;2018-01-05 07:31:56.627;2018-01-05 09:33:08.990;122;33;89;56
42;42;2018-01-05 07:37:11.757;2018-01-05 09:33:08.990;116;33;89;56
42;42;2018-01-09 06:43:48.650;2018-01-09 09:43:07.447;180;34;88;54
42;42;2018-01-12 03:29:05.257;2018-01-12 05:51:53.950;142;33;89;56
42;42;2018-01-12 03:51:35.823;2018-01-12 05:51:53.950;120;33;89;56
42;42;2018-01-10 23:04:43.287;2018-01-11 00:56:30.167;112;33;89;56
42;42;2018-01-09 23:37:02.567;2018-01-10 04:18:00.330;281;34;91;57
42;42;2018-01-09 23:43:06.857;2018-01-10 04:18:00.330;275;34;91;57
42;42;2018-01-17 07:59:16.587;2018-01-17 11:07:58.070;188;33;89;56
42;42;2018-01-16 06:41:16.027;2018-01-16 09:35:11.267;174;34;87;53
42;42;2018-01-16 09:38:09.830;2018-01-16 09:54:56.540;16;86;89;3
42;42;2018-01-24 15:40:02.920;2018-01-24 17:32:56.860;112;34;89;55
42;42;2018-01-25 16:25:43.410;2018-01-25 18:18:02.547;113;34;89;55
42;42;2018-02-01 08:19:08.710;2018-02-01 10:12:05.147;113;34;89;55
42;42;2018-02-16 01:48:02.753;2018-02-16 03:54:49.960;126;29;89;60
42;42;2018-02-21 03:11:10.170;2018-02-21 04:44:09.747;93;31;89;58
42;42;2018-02-22 17:18:08.293;2018-02-22 18:37:05.023;79;33;89;56
42;42;2018-02-26 10:34:20.507;2018-02-26 11:53:31.690;79;33;89;56
42;42;2018-03-13 08:06:28.870;2018-03-13 12:25:51.413;259;33;92;59
42;42;2018-03-14 09:20:31.600;2018-03-14 10:42:54.450;82;34;89;55
42;42;2018-02-06 11:15:27.810;2018-02-06 13:46:28.190;151;33;89;56
42;42;2018-02-08 10:33:54.977;2018-02-08 15:17:51.463;284;34;93;59
42;42;2018-02-09 16:06:39.717;2018-02-09 17:29:53.160;83;33;89;56
42;42;2018-03-07 15:37:17.450;2018-03-07 16:57:54.183;80;34;89;55
42;42;2018-03-12 06:44:40.070;2018-03-12 09:32:17.563;168;34;89;55
42;42;2018-05-23 07:27:38.860;2018-05-23 10:00:42.233;153;34;89;55
42;42;2018-05-23 07:31:22.727;2018-05-23 10:00:42.233;149;34;89;55
42;42;2018-06-12 09:27:59.457;2018-06-12 10:47:08.240;80;33;89;56
42;42;2018-06-17 22:11:01.730;2018-06-18 02:51:32.697;280;29;100;71
42;42;2018-07-02 18:02:26.297;2018-07-03 13:38:41.647;1176;34;93;59
42;42;2018-07-02 18:19:30.140;2018-07-03 13:38:41.647;1159;34;93;59
42;42;2018-07-02 18:58:33.500;2018-07-03 13:38:41.647;1120;34;93;59
42;42;2018-07-09 14:53:54.003;2018-07-09 16:15:52.430;82;34;89;55
42;42;2018-05-28 14:59:26.033;2018-05-28 16:22:59.970;83;34;89;55
42;42;2018-05-31 18:14:38.137;2018-05-31 20:49:31.350;155;32;89;57
42;42;2018-06-04 12:39:24.730;2018-06-04 14:02:44.543;83;33;89;56
42;42;2018-06-05 07:36:18.120;2018-06-05 09:04:43.773;88;34;89;55
42;42;2018-06-05 07:40:47.270;2018-06-05 09:04:43.773;84;34;89;55
42;42;2018-06-26 07:05:57.700;2018-06-26 08:44:15.047;99;32;89;57
42;42;2018-06-27 18:11:36.283;2018-06-27 19:42:12.140;91;33;89;56
42;42;2018-06-28 21:54:08.020;2018-06-28 23:38:10.790;104;33;89;56
42;42;2018-07-12 08:52:57.680;2018-07-12 10:56:54.463;124;33;89;56
42;42;2018-07-12 09:15:44.070;2018-07-12 10:56:54.463;101;33;89;56
42;42;2018-07-13 03:03:57.207;2018-07-13 05:15:26.340;132;34;89;55
42;42;2018-07-13 03:15:24.287;2018-07-13 05:15:26.340;120;34;89;55
42;42;2018-07-16 00:13:08.670;2018-07-16 04:12:03.750;239;32;89;57
42;42;2018-07-18 11:59:54.280;2018-07-18 15:13:55.850;194;34;89;55
42;42;2018-07-18 12:18:09.957;2018-07-18 15:13:55.850;175;34;89;55
42;42;2018-07-18 12:19:00.033;2018-07-18 15:13:55.850;174;34;89;55
42;42;2018-09-18 10:58:57.303;2018-09-18 13:03:53.743;125;34;88;54
42;42;2018-09-19 06:37:45.920;2018-09-20 16:49:56.180;2052;33;99;66
42;42;2018-09-19 14:50:38.723;2018-09-20 16:49:56.180;1559;98;99;1
42;42;2018-09-20 11:53:46.343;2018-09-20 16:49:56.180;296;33;99;66
42;42;2018-09-24 07:44:09.407;2018-09-24 09:19:14.757;95;33;89;56
42;42;2018-09-26 12:26:37.493;2018-09-26 14:24:00.367;118;34;89;55
42;42;2018-09-04 09:44:25.583;2018-09-04 13:21:17.653;217;25;80;55
42;42;2018-07-25 11:18:50.100;2018-09-04 13:21:17.653;59163;27;80;53
42;42;2018-09-05 06:29:43.580;2018-09-05 10:17:46.607;228;33;91;58
42;42;2018-09-06 08:20:46.287;2018-09-06 09:52:20.237;92;34;89;55
44;44;2018-09-04 19:53:15.407;2018-09-04 22:03:14.607;130;33;89;56
44;44;2018-08-30 11:43:02.993;2018-08-30 13:07:10.160;84;34;89;55
44;44;2018-08-28 13:31:36.867;2018-08-28 16:23:17.500;172;33;89;56
33;33;2018-07-13 07:42:15.627;2018-07-13 08:54:08.527;72;33;89;56
33;33;2018-07-18 19:38:20.300;2018-07-18 20:52:20.543;74;33;89;56
33;33;2018-07-20 03:47:30.397;2018-07-20 05:12:54.213;85;33;61;28
33;33;2018-07-31 09:02:05.950;2018-07-31 10:41:17.243;99;32;89;57
33;33;2018-08-07 12:19:27.010;2018-08-07 13:33:04.057;74;33;89;56
33;33;2018-08-15 22:16:57.980;2018-08-16 08:35:09.567;619;31;89;58
33;33;2018-08-16 06:41:50.633;2018-08-16 08:35:09.567;114;21;89;68
33;33;2018-08-16 06:41:55.010;2018-08-16 08:35:09.567;114;20;89;69
33;33;2018-08-16 06:42:04.333;2018-08-16 08:35:09.567;113;20;89;69
33;33;2018-08-16 06:42:06.257;2018-08-16 08:35:09.567;113;20;89;69
33;33;2018-08-16 06:42:15.887;2018-08-16 08:35:09.567;113;20;89;69
33;33;2018-08-16 06:42:19.303;2018-08-16 08:35:09.567;113;20;89;69
33;33;2018-08-17 03:29:14.860;2018-08-17 04:51:19.273;82;34;89;55
33;33;2018-08-16 09:01:23.260;2018-08-17 04:51:19.273;1190;88;89;1
33;33;2018-08-20 17:31:52.487;2018-08-20 18:58:27.420;87;34;89;55
33;33;2018-08-23 04:10:45.473;2018-08-23 05:38:57.737;88;31;89;58
33;33;2018-09-11 06:46:26.587;2018-09-11 08:25:53.183;99;34;89;55
33;33;2018-09-10 12:32:38.740;2018-09-10 13:46:40.103;74;33;89;56
33;33;2018-09-13 09:15:17.150;2018-09-13 12:07:36.407;172;34;89;55
33;33;2018-09-13 10:48:16.677;2018-09-13 12:07:36.407;79;33;89;56
33;33;2018-09-27 15:28:26.307;2018-09-27 17:04:02.143;96;34;89;55
33;33;2018-05-24 09:39:54.833;2018-05-24 11:02:11.607;83;34;89;55
33;33;2018-06-06 07:05:06.620;2018-06-06 08:18:04.613;73;33;89;56
33;33;2018-06-13 10:53:29.837;2018-06-13 12:18:16.387;85;34;89;55
33;33;2018-07-06 03:20:53.730;2018-07-06 04:48:19.560;88;31;89;58
33;33;2018-07-09 12:49:05.573;2018-07-09 15:00:54.703;131;33;89;56
33;33;2018-07-09 12:50:20.447;2018-07-09 15:00:54.703;130;33;89;56
33;33;2018-07-24 08:19:57.170;2018-07-24 08:58:25.057;39;34;60;26
33;33;2018-07-24 15:08:18.633;2018-07-24 16:37:04.903;89;34;89;55
33;33;2018-08-08 17:20:53.077;2018-08-08 18:37:56.163;77;32;89;57
33;33;2018-08-13 11:38:15.460;2018-08-13 15:09:16.987;211;33;89;56
33;33;2018-08-13 13:45:09.780;2018-08-13 15:09:16.987;84;34;89;55
33;33;2018-08-29 08:41:22.860;2018-08-29 09:59:08.687;78;33;89;56
33;33;2018-09-03 12:03:06.640;2018-09-03 12:31:45.200;28;34;56;22
37;37;2017-10-01 22:16:35.203;2017-10-02 00:29:30.710;133;14;96;82
37;37;2017-10-02 00:30:33.917;2017-10-02 00:30:34.880;0;98;100;2
42;42;2017-10-24 13:41:47.550;2017-10-24 15:41:50.713;120;34;89;55
42;42;2017-10-25 09:20:52.750;2017-10-25 11:17:26.190;117;34;87;53
42;42;2017-10-28 13:01:19.280;2017-10-28 15:51:28.967;170;39;100;61
42;42;2017-11-02 15:05:23.713;2017-11-02 16:44:21.667;99;34;89;55
42;42;2017-11-06 09:48:23.823;2017-11-06 13:05:22.923;197;34;93;59
42;42;2017-11-03 12:21:42.533;2017-11-03 14:46:22.897;145;34;89;55
42;42;2017-11-21 03:02:35.570;2017-11-21 06:15:20.633;193;33;92;59
42;42;2017-11-22 16:45:02.653;2017-11-22 17:49:29.717;64;34;89;55
42;42;2017-11-27 02:51:05.617;2017-11-27 07:32:14.120;281;31;100;69
42;42;2017-11-27 02:53:33.063;2017-11-27 07:32:14.120;279;30;100;70
42;42;2017-11-24 09:44:07.963;2017-11-24 10:05:22.507;21;34;46;12
42;42;2017-11-24 10:09:19.220;2017-11-24 10:10:47.530;1;46;47;1
42;42;2017-11-24 10:11:50.503;2017-11-24 11:29:42.867;78;47;89;42
42;42;2017-11-23 10:10:46.800;2017-11-23 10:21:28.270;11;34;38;4
42;42;2017-11-29 18:10:45.230;2017-11-29 20:06:52.683;116;33;89;56
42;42;2017-12-01 05:30:30.990;2017-12-01 07:46:42.837;136;34;89;55
42;42;2017-11-30 12:46:51.403;2017-11-30 14:49:04.877;123;34;89;55
42;42;2017-12-05 02:46:48.517;2017-12-05 04:40:59.040;114;34;89;55
42;42;2017-12-04 11:57:17.037;2017-12-04 13:09:33.327;72;34;71;37
42;42;2017-12-13 09:07:57.277;2017-12-13 11:23:29.170;136;34;89;55
42;42;2017-12-15 19:49:58.873;2017-12-15 22:28:05.073;159;34;89;55
42;42;2017-12-19 01:52:14.993;2017-12-19 03:43:47.210;111;34;89;55
42;42;2017-12-19 15:08:59.040;2017-12-19 17:08:00.777;120;34;89;55
42;42;2017-12-21 09:13:26.163;2017-12-21 11:37:49.553;144;34;91;57
42;42;2017-12-21 09:24:40.447;2017-12-21 11:37:49.553;133;34;91;57
42;42;2017-12-20 12:31:02.930;2017-12-20 15:04:31.140;153;34;89;55
42;42;2017-12-27 03:49:24.900;2017-12-27 06:55:37.880;186;33;89;56
42;42;2017-12-27 05:01:53.890;2017-12-27 06:55:37.880;114;33;89;56
42;42;2018-01-02 17:05:59.923;2018-01-02 21:58:33.100;293;34;100;66
42;42;2018-01-05 07:35:27.773;2018-01-05 09:33:08.990;118;33;89;56
42;42;2018-01-08 06:49:33.520;2018-01-08 09:01:48.407;132;34;89;55
42;42;2018-01-09 05:31:08.620;2018-01-09 09:43:07.447;252;34;88;54
42;42;2018-01-12 03:25:53.050;2018-01-12 05:51:53.950;146;33;89;56
42;42;2018-01-12 03:52:33.110;2018-01-12 05:51:53.950;119;33;89;56
42;42;2018-01-16 06:44:23.220;2018-01-16 09:35:11.267;171;34;87;53
42;42;2018-01-16 06:45:15.663;2018-01-16 09:35:11.267;170;34;87;53
42;42;2018-01-19 18:06:43.063;2018-01-19 21:36:42.637;210;33;89;56
42;42;2018-01-22 07:32:56.747;2018-01-22 09:57:38.663;145;33;88;55
42;42;2018-01-22 07:34:39.793;2018-01-22 09:57:38.663;143;33;88;55
42;42;2018-01-26 17:40:39.477;2018-01-26 19:40:44.780;120;33;89;56
42;42;2018-01-29 05:27:54.157;2018-01-29 07:49:43.497;142;64;89;25
42;42;2018-01-30 21:24:37.510;2018-01-30 23:28:34.290;124;34;93;59
42;42;2018-02-01 23:41:14.290;2018-02-02 09:32:10.177;591;45;89;44
42;42;2018-02-02 06:43:02.953;2018-02-02 09:32:10.177;169;34;89;55
42;42;2018-02-02 07:44:20.970;2018-02-02 09:32:10.177;108;34;89;55
42;42;2018-02-20 05:19:47.543;2018-02-20 06:50:48.253;91;31;89;58
42;42;2018-02-21 21:03:47.453;2018-02-21 22:37:22.783;94;34;89;55
42;42;2018-02-22 17:04:42.613;2018-02-22 18:37:05.023;93;33;89;56
42;42;2018-02-27 06:50:25.177;2018-02-27 18:47:12.500;717;84;89;5
42;42;2018-03-15 18:31:59.987;2018-03-15 20:00:07.657;89;33;89;56
42;42;2018-03-16 12:32:27.233;2018-03-16 14:08:51.610;96;33;89;56
42;42;2018-03-22 06:34:16.913;2018-03-22 07:58:09.187;84;34;89;55
42;42;2018-02-05 16:16:40.490;2018-02-05 18:29:02.840;133;32;87;55
42;42;2018-02-05 16:26:51.523;2018-02-05 18:29:02.840;123;32;87;55
42;42;2018-02-07 15:09:03.430;2018-02-08 15:17:51.463;1448;87;93;6
42;42;2018-02-08 10:30:51.810;2018-02-08 15:17:51.463;287;34;93;59
42;42;2018-02-09 16:10:38.717;2018-02-09 17:29:53.160;79;33;89;56
42;42;2018-02-12 20:39:44.920;2018-02-12 22:00:48.833;81;34;89;55
42;42;2018-03-02 16:04:06.673;2018-03-02 18:00:26.480;116;34;89;55
42;42;2018-03-01 21:04:43.450;2018-03-01 22:45:36.007;101;34;89;55
42;42;2018-06-06 15:33:14.467;2018-06-06 17:57:56.550;144;34;74;40
42;42;2018-06-06 15:41:59.450;2018-06-06 17:57:56.550;136;34;74;40
42;42;2018-06-06 16:55:11.197;2018-06-06 17:57:56.550;62;34;74;40
42;42;2018-06-13 15:10:11.290;2018-06-13 16:33:43.270;83;34;89;55
42;42;2018-06-15 13:28:06.623;2018-06-15 15:09:27.080;101;32;89;57
42;42;2018-07-03 12:04:07.810;2018-07-03 13:38:41.647;94;34;93;59
42;42;2018-07-03 12:09:06.773;2018-07-03 13:38:41.647;89;34;93;59
42;42;2018-07-05 00:04:47.120;2018-07-05 02:27:12.507;143;33;89;56
42;42;2018-07-06 09:38:39.760;2018-07-07 02:51:32.900;1033;34;89;55
42;42;2018-05-30 07:30:05.517;2018-05-30 09:05:23.727;95;34;89;55
42;42;2018-06-04 12:37:32.517;2018-06-04 14:02:44.543;85;33;89;56
42;42;2018-06-20 08:21:47.623;2018-06-20 09:49:10.783;88;34;89;55
42;42;2018-06-22 06:34:19.120;2018-06-22 08:23:26.863;109;34;89;55
42;42;2018-06-25 01:59:50.090;2018-06-25 06:35:40.843;276;34;92;58
42;42;2018-06-21 05:50:22.783;2018-06-21 07:24:45.820;94;34;89;55
42;42;2018-07-19 07:00:20.253;2018-07-19 08:33:42.093;93;34;89;55
42;42;2018-07-19 22:07:29.907;2018-07-20 08:04:08.850;597;33;89;56
42;42;2018-07-20 06:08:07.950;2018-07-20 08:04:08.850;116;33;89;56
42;42;2018-09-11 06:48:50.320;2018-09-11 08:48:58.017;120;33;89;56
42;42;2018-09-11 06:54:29.780;2018-09-11 08:48:58.017;114;33;89;56
42;42;2018-09-12 15:05:57.443;2018-09-13 06:16:11.890;911;30;92;62
42;42;2018-09-13 01:45:16.703;2018-09-13 06:16:11.890;271;34;92;58
42;42;2018-09-18 11:10:23.527;2018-09-18 13:03:53.743;113;34;88;54
42;42;2018-09-22 14:01:35.530;2018-09-22 17:06:02.580;185;49;100;51
42;42;2018-09-24 21:57:30.367;2018-09-24 23:24:29.227;87;34;89;55
42;42;2018-09-25 15:07:16.410;2018-09-25 22:12:03.307;425;34;89;55
42;42;2018-09-27 20:23:46.677;2018-09-27 23:04:47.790;161;34;89;55
44;44;2018-09-06 10:54:37.077;2018-09-06 12:26:45.350;92;33;89;56
44;44;2018-09-05 14:31:57.027;2018-09-05 16:31:13.350;120;34;89;55
44;44;2018-09-04 04:56:34.133;2018-09-04 06:49:17.077;113;33;89;56
44;44;2018-08-31 07:45:04.257;2018-08-31 09:18:24.270;93;34;89;55
37;37;2017-10-01 22:28:19.330;2017-10-02 00:29:30.710;121;14;96;82
42;42;2017-10-23 21:04:17.690;2017-10-23 22:31:45.933;87;33;89;56
42;42;2017-10-23 21:03:06.617;2017-10-23 22:31:45.933;88;33;89;56
42;42;2017-10-30 21:39:58.083;2017-10-30 23:08:55.770;89;34;89;55
42;42;2017-11-06 09:42:02.123;2017-11-06 13:05:22.923;203;34;93;59
42;42;2017-11-03 12:13:15.903;2017-11-03 14:46:22.897;153;34;89;55
42;42;2017-11-07 08:19:37.877;2017-11-07 09:25:27.960;66;34;89;55
42;42;2017-11-16 10:41:04.293;2017-11-16 11:44:26.247;63;37;89;52
42;42;2017-11-15 16:23:59.177;2017-11-15 17:41:06.747;78;33;89;56
42;42;2017-11-17 09:33:59.983;2017-11-17 11:01:15.767;88;33;89;56
42;42;2017-11-27 02:42:01.110;2017-11-27 07:32:14.120;290;31;100;69
42;42;2017-11-27 02:49:26.283;2017-11-27 07:32:14.120;283;31;100;69
42;42;2017-11-28 13:27:55.650;2017-11-28 15:19:25.557;112;34;89;55
42;42;2017-11-27 20:45:24.963;2017-11-27 22:37:39.477;112;34;89;55
42;42;2017-12-02 08:53:36.910;2017-12-02 13:31:45.383;278;41;100;59
42;42;2017-12-07 08:16:45.350;2017-12-07 11:50:10.660;214;33;89;56
42;42;2017-12-07 23:57:23.060;2017-12-08 02:56:46.843;179;48;93;45
42;42;2017-12-15 19:40:10.190;2017-12-15 22:28:05.073;168;34;89;55
42;42;2017-12-15 20:33:35.113;2017-12-15 22:28:05.073;115;34;89;55
42;42;2017-12-28 20:28:39.503;2017-12-28 22:22:50.343;114;34;89;55
42;42;2017-12-28 03:23:36.693;2017-12-28 03:32:53.157;9;84;89;5
42;42;2018-01-02 10:33:53.750;2018-01-02 11:32:12.907;59;34;63;29
42;42;2018-01-03 16:19:48.970;2018-01-03 16:27:07.797;8;85;89;4
42;42;2018-01-04 09:33:26.680;2018-01-04 11:36:19.483;123;34;89;55
42;42;2018-01-12 03:18:08.667;2018-01-12 05:51:53.950;153;33;89;56
42;42;2018-01-12 03:27:56.997;2018-01-12 05:51:53.950;144;33;89;56
42;42;2018-01-10 22:58:37.517;2018-01-11 00:56:30.167;118;33;89;56
42;42;2018-01-17 07:55:43.370;2018-01-17 11:07:58.070;192;33;89;56
42;42;2018-01-19 18:02:57.130;2018-01-19 21:36:42.637;214;33;89;56
42;42;2018-01-23 10:14:11.640;2018-01-23 15:37:13.357;323;33;100;67
42;42;2018-01-23 10:19:51.240;2018-01-23 15:37:13.357;318;33;100;67
42;42;2018-02-01 23:18:01.527;2018-02-01 23:38:12.287;20;41;45;4
42;42;2018-02-21 21:06:37.373;2018-02-21 22:37:22.783;91;34;89;55
42;42;2018-02-22 17:07:01.693;2018-02-22 18:37:05.023;90;33;89;56
42;42;2018-02-26 10:30:26.710;2018-02-26 11:53:31.690;83;33;89;56
42;42;2018-02-27 17:23:34.667;2018-02-27 18:47:12.500;84;33;89;56
42;42;2018-03-15 05:28:26.773;2018-03-15 06:45:32.753;77;34;86;52
42;42;2018-03-21 08:11:17.810;2018-03-21 09:34:13.120;83;33;89;56
42;42;2018-03-23 11:48:32.977;2018-03-23 13:21:02.640;93;34;89;55
42;42;2018-02-11 23:01:23.710;2018-02-12 03:25:34.010;264;34;100;66
42;42;2018-02-14 11:15:37.293;2018-02-14 12:42:30.770;87;34;89;55
42;42;2018-03-01 07:17:33.600;2018-03-01 08:50:26.893;93;34;89;55
42;42;2018-03-06 23:16:03.427;2018-03-07 00:38:18.263;82;34;89;55
42;42;2018-03-05 20:45:56.387;2018-03-06 01:33:23.313;288;34;100;66
42;42;2018-03-08 23:33:40.150;2018-03-09 01:04:31.537;91;34;89;55
42;42;2018-03-08 09:34:20.797;2018-03-08 11:02:40.413;88;33;89;56
42;42;2018-03-09 15:16:42.363;2018-03-09 16:59:51.200;103;34;89;55
42;42;2018-05-16 07:34:07.623;2018-05-16 09:09:11.417;95;34;89;55
42;42;2018-05-21 17:38:26.160;2018-05-21 19:18:14.073;100;33;89;56
42;42;2018-05-22 11:32:27.380;2018-05-22 13:30:16.933;118;34;89;55
42;42;2018-05-23 07:30:28.303;2018-05-23 10:00:42.233;150;34;89;55
42;42;2018-05-24 22:21:12.383;2018-05-25 00:04:26.657;103;30;89;59
42;42;2018-05-25 15:49:45.460;2018-05-25 17:17:56.963;88;34;89;55
42;42;2018-06-18 19:35:37.260;2018-06-18 20:59:06.080;84;34;89;55
42;42;2018-07-03 12:08:10.313;2018-07-03 13:38:41.647;90;34;93;59
42;42;2018-07-05 00:31:15.833;2018-07-05 02:27:12.507;116;33;89;56
42;42;2018-07-05 01:08:24.533;2018-07-05 02:27:12.507;79;33;89;56
42;42;2018-07-05 14:23:27.393;2018-07-05 15:39:34.353;76;33;89;56
42;42;2018-07-07 00:18:06.493;2018-07-07 02:51:32.900;153;34;89;55
42;42;2018-07-07 01:23:44.500;2018-07-07 02:51:32.900;88;34;89;55
42;42;2018-07-07 01:24:54.457;2018-07-07 02:51:32.900;87;34;89;55
42;42;2018-07-07 01:25:58.560;2018-07-07 02:51:32.900;86;34;89;55
42;42;2018-07-07 01:31:05.843;2018-07-07 02:51:32.900;80;34;89;55
42;42;2018-05-26 14:01:34.190;2018-05-26 18:03:33.810;242;53;100;47
42;42;2018-05-29 13:36:37.087;2018-05-29 15:09:35.520;93;34;89;55
42;42;2018-05-29 13:40:34.540;2018-05-29 15:09:35.520;89;34;89;55
42;42;2018-06-01 13:23:26.663;2018-06-01 17:03:58.727;220;34;89;55
42;42;2018-06-28 16:05:43.960;2018-06-28 23:38:10.790;453;40;89;49
42;42;2018-06-28 21:53:24.890;2018-06-28 23:38:10.790;105;33;89;56
42;42;2018-07-16 20:30:27.440;2018-07-16 21:56:09.063;86;33;89;56
42;42;2018-07-20 06:07:25.337;2018-07-20 08:04:08.850;117;33;89;56
42;42;2018-09-10 11:33:29.270;2018-09-10 13:16:30.933;103;34;89;55
42;42;2018-09-17 10:04:39.037;2018-09-17 11:39:30.367;95;34;85;51
42;42;2018-09-17 10:09:13.783;2018-09-17 11:39:30.367;90;34;85;51
42;42;2018-09-19 11:09:41.420;2018-09-20 16:49:56.180;1780;34;99;65
42;42;2018-09-19 11:45:36.413;2018-09-20 16:49:56.180;1744;34;99;65
42;42;2018-09-19 11:46:30.703;2018-09-20 16:49:56.180;1743;34;99;65
42;42;2018-09-21 12:08:37.740;2018-09-21 13:34:53.150;86;34;89;55
42;42;2018-09-24 07:56:52.673;2018-09-24 09:19:14.757;83;33;89;56
42;42;2018-09-27 12:59:44.603;2018-09-27 13:40:56.420;41;33;58;25
42;42;2018-09-25 14:14:11.673;2018-09-25 22:12:03.307;478;34;89;55
42;42;2018-09-25 20:35:09.087;2018-09-25 22:12:03.307;97;34;89;55
42;42;2018-09-27 20:29:25.897;2018-09-27 23:04:47.790;155;34;89;55
42;42;2018-09-27 20:49:23.820;2018-09-27 23:04:47.790;135;34;89;55
42;42;2018-09-04 09:20:29.540;2018-09-04 13:21:17.653;241;25;80;55
42;42;2018-07-25 11:18:05.320;2018-09-04 13:21:17.653;59163;27;80;53
42;42;2018-09-06 08:22:54.970;2018-09-06 09:52:20.237;90;34;89;55
44;44;2018-09-06 11:51:06.123;2018-09-06 12:26:45.350;35;65;89;24
44;44;2018-08-13 20:37:52.683;2018-08-13 22:03:28.833;86;34;89;55
44;44;2018-08-27 23:02:15.093;2018-08-28 00:48:13.073;106;34;86;52
44;44;2018-08-29 12:09:19.723;2018-08-29 16:09:33.297;240;33;89;56
44;44;2018-09-28 15:53:26.420;2018-09-29 00:44:44.613;531;33;89;56
44;44;2018-09-28 22:36:56.190;2018-09-29 00:44:44.613;128;33;89;56
44;44;2018-09-28 00:39:35.343;2018-09-29 00:44:44.613;1445;31;89;58
44;44;2018-09-27 17:15:48.203;2018-09-29 00:44:44.613;1889;33;89;56
44;44;2018-09-25 21:14:33.110;2018-09-25 23:15:55.043;121;33;89;56
44;44;2018-09-24 15:42:08.830;2018-09-24 21:01:41.667;319;33;100;67
44;44;2018-09-24 10:11:56.477;2018-09-24 21:01:41.667;650;34;100;66
44;44;2018-09-24 10:42:28.600;2018-09-24 21:01:41.667;619;33;100;67
44;44;2018-09-24 11:15:44.340;2018-09-24 21:01:41.667;586;33;100;67
44;44;2018-09-21 12:27:44.243;2018-09-22 13:55:56.097;1528;33;89;56
44;44;2018-09-20 16:16:40.193;2018-09-20 18:10:57.540;114;33;89;56
44;44;2018-09-20 16:30:03.353;2018-09-20 18:10:57.540;100;33;89;56
44;44;2018-09-20 16:35:40.703;2018-09-20 18:10:57.540;95;33;89;56
44;44;2018-09-20 16:36:54.160;2018-09-20 18:10:57.540;94;33;89;56
44;44;2018-09-11 12:07:29.570;2018-09-11 13:42:35.087;95;33;89;56
44;44;2018-09-11 12:08:49.060;2018-09-11 13:42:35.087;94;33;89;56
44;44;2018-09-12 07:05:34.110;2018-09-12 08:47:18.067;102;33;89;56
44;44;2018-09-10 19:11:50.880;2018-09-10 20:49:20.507;98;33;89;56
44;44;2018-08-01 13:00:45.250;2018-08-01 14:22:54.590;82;33;89;56
44;44;2018-08-07 06:35:32.600;2018-08-07 07:54:44.023;79;33;89;56
44;44;2018-08-17 11:29:47.573;2018-08-17 13:21:57.540;112;34;89;55
44;44;2018-07-16 06:20:51.587;2018-07-16 08:33:46.223;133;15;89;74
44;44;2018-07-16 06:32:37.933;2018-07-16 08:33:46.223;121;15;89;74
44;44;2018-06-22 17:27:15.833;2018-06-22 19:00:26.767;93;33;89;56
44;44;2018-06-21 21:23:16.440;2018-06-22 19:00:26.767;1297;33;89;56
44;44;2018-05-31 18:00:36.507;2018-05-31 23:10:23.623;310;33;92;59
44;44;2018-05-15 08:38:19.063;2018-05-15 10:16:52.427;98;34;89;55
44;44;2018-05-28 05:12:07.900;2018-05-28 08:01:53.333;169;30;89;59
44;44;2018-08-09 03:51:13.147;2018-08-09 05:12:00.533;81;33;89;56
44;44;2018-07-24 12:26:43.203;2018-07-24 14:24:18.157;118;34;89;55
44;44;2018-07-24 13:01:24.210;2018-07-24 14:24:18.157;83;34;89;55
44;44;2018-07-23 09:59:08.020;2018-07-23 11:19:14.933;80;34;89;55
44;44;2018-07-06 10:55:36.247;2018-07-06 12:58:18.500;123;33;89;56
44;44;2018-07-03 14:27:27.633;2018-07-03 15:53:24.437;86;33;89;56
44;44;2018-07-02 19:47:17.300;2018-07-02 21:09:58.450;82;34;89;55
44;44;2018-06-18 14:06:14.967;2018-06-18 15:38:47.850;92;33;89;56
42;42;2018-06-28 15:37:04.570;2018-06-28 23:38:10.790;481;34;89;55
42;42;2018-07-12 09:14:50.337;2018-07-12 10:56:54.463;102;33;89;56
42;42;2018-07-13 03:16:20.210;2018-07-13 05:15:26.340;119;34;89;55
42;42;2018-07-17 15:19:36.487;2018-07-17 16:45:31.857;86;33;89;56
42;42;2018-07-18 12:08:05.830;2018-07-18 15:13:55.850;185;34;89;55
42;42;2018-07-18 13:48:54.510;2018-07-18 15:13:55.850;85;34;89;55
42;42;2018-09-07 12:08:55.323;2018-09-07 13:35:15.580;87;34;89;55
42;42;2018-09-11 06:39:26.273;2018-09-11 08:48:58.017;129;33;89;56
42;42;2018-09-13 03:37:56.117;2018-09-13 06:16:11.890;159;34;92;58
42;42;2018-09-13 23:53:02.583;2018-09-14 02:21:16.300;148;33;89;56
42;42;2018-09-14 00:51:34.320;2018-09-14 02:21:16.300;90;33;89;56
42;42;2018-09-15 09:58:43.867;2018-09-17 11:39:30.367;2981;30;85;55
42;42;2018-09-17 10:20:21.133;2018-09-17 11:39:30.367;79;34;85;51
42;42;2018-09-19 06:30:50.230;2018-09-20 16:49:56.180;2059;33;99;66
42;42;2018-09-19 11:01:43.077;2018-09-20 16:49:56.180;1788;34;99;65
42;42;2018-09-21 11:44:13.520;2018-09-21 13:34:53.150;110;35;89;54
42;42;2018-09-21 12:07:11.130;2018-09-21 13:34:53.150;87;34;89;55
42;42;2018-09-27 20:08:06.923;2018-09-27 23:04:47.790;176;34;89;55
42;42;2018-09-28 16:04:42.040;2018-09-28 19:07:34.560;183;34;89;55
42;42;2018-09-06 08:21:30.293;2018-09-06 09:52:20.237;91;34;89;55
42;42;2018-09-06 08:24:00.253;2018-09-06 09:52:20.237;88;34;89;55
44;44;2018-09-06 10:52:13.420;2018-09-06 12:26:45.350;94;33;89;56
44;44;2018-09-04 20:13:32.500;2018-09-04 22:03:14.607;110;33;89;56
44;44;2018-09-04 04:57:25.743;2018-09-04 06:49:17.077;112;33;89;56
44;44;2018-09-04 05:09:18.073;2018-09-04 06:49:17.077;100;33;89;56
44;44;2018-08-31 07:52:36.420;2018-08-31 09:18:24.270;86;34;89;55
44;44;2018-08-31 07:53:46.697;2018-08-31 09:18:24.270;85;34;89;55
44;44;2018-08-27 10:01:42.293;2018-08-28 00:48:13.073;887;34;86;52
44;44;2018-08-29 12:37:51.390;2018-08-29 16:09:33.297;212;33;89;56
44;44;2018-09-28 02:54:38.727;2018-09-29 00:44:44.613;1310;31;89;58
44;44;2018-09-28 04:58:13.927;2018-09-29 00:44:44.613;1186;75;89;14
44;44;2018-09-26 15:16:51.057;2018-09-29 00:44:44.613;3448;34;89;55
44;44;2018-09-26 15:17:57.360;2018-09-29 00:44:44.613;3447;34;89;55
44;44;2018-09-26 20:14:20.977;2018-09-29 00:44:44.613;3150;31;89;58
44;44;2018-08-09 19:41:51.690;2018-08-09 21:03:42.177;82;34;89;55
44;44;2018-09-25 21:00:19.187;2018-09-25 23:15:55.043;135;33;89;56
44;44;2018-09-25 18:47:21.490;2018-09-25 23:15:55.043;268;33;89;56
44;44;2018-09-24 10:25:33.980;2018-09-24 21:01:41.667;636;33;100;67
44;44;2018-09-24 11:33:42.553;2018-09-24 21:01:41.667;568;33;100;67
44;44;2018-09-24 11:50:07.713;2018-09-24 21:01:41.667;551;33;100;67
44;44;2018-09-21 12:31:07.070;2018-09-22 13:55:56.097;1524;33;89;56
44;44;2018-09-22 11:32:46.697;2018-09-22 13:55:56.097;143;32;89;57
44;44;2018-09-22 11:37:03.073;2018-09-22 13:55:56.097;138;32;89;57
44;44;2018-09-20 16:19:40.600;2018-09-20 18:10:57.540;111;33;89;56
44;44;2018-09-18 23:05:32.637;2018-09-19 03:45:50.927;280;34;89;55
44;44;2018-09-13 02:09:42.180;2018-09-13 03:56:11.530;107;34;89;55
44;44;2018-09-11 12:04:44.787;2018-09-11 13:42:35.087;98;33;89;56
44;44;2018-09-07 16:47:59.463;2018-09-10 04:34:38.203;3587;34;89;55
44;44;2018-08-24 21:11:08.233;2018-08-24 22:59:42.990;108;34;89;55
44;44;2018-08-02 07:11:24.860;2018-08-02 08:41:27.130;90;34;89;55
44;44;2018-08-02 07:18:14.923;2018-08-02 08:41:27.130;83;34;89;55
44;44;2018-08-16 17:18:06.803;2018-08-16 19:01:41.217;103;33;89;56
44;44;2018-08-21 10:19:22.510;2018-08-21 11:41:37.017;82;34;89;55
44;44;2018-07-20 14:42:56.540;2018-07-20 16:24:59.553;102;34;92;58
44;44;2018-07-16 06:18:50.213;2018-07-16 08:33:46.223;135;16;89;73
44;44;2018-07-16 06:30:51.617;2018-07-16 08:33:46.223;123;15;89;74
44;44;2018-06-27 03:47:54.873;2018-06-27 06:04:31.467;137;34;89;55
44;44;2018-06-25 13:34:27.177;2018-06-25 15:25:40.010;111;34;89;55
44;44;2018-06-04 12:55:56.620;2018-06-04 14:25:12.567;90;33;89;56
44;44;2018-06-04 12:57:48.300;2018-06-04 14:25:12.567;88;33;89;56
44;44;2018-05-28 02:02:21.283;2018-05-28 08:01:53.333;359;32;89;57
44;44;2018-05-28 03:04:36.277;2018-05-28 08:01:53.333;297;32;89;57
44;44;2018-05-10 10:28:40.870;2018-05-10 15:32:12.930;304;34;100;66
44;44;2018-05-11 16:38:47.557;2018-05-12 04:51:05.630;733;34;89;55
44;44;2018-05-12 03:23:27.930;2018-05-12 04:51:05.630;88;33;89;56
44;44;2018-08-08 09:49:33.663;2018-08-08 11:09:16.387;80;33;89;56
44;44;2018-07-30 15:24:11.240;2018-07-30 17:17:48.050;113;34;89;55
44;44;2018-07-25 09:33:11.713;2018-07-25 10:34:20.920;61;34;74;40
44;44;2018-07-24 12:28:10.467;2018-07-24 14:24:18.157;116;34;89;55
44;44;2018-07-25 21:20:08.850;2018-07-25 22:51:08.373;91;33;89;56
44;44;2018-07-12 02:57:52.483;2018-07-12 04:18:21.813;81;33;89;56
44;44;2018-07-05 11:48:34.887;2018-07-05 13:29:19.913;101;33;89;56
44;44;2018-06-11 13:42:18.620;2018-06-11 16:11:38.017;149;33;95;62
44;44;2018-06-09 10:03:14.323;2018-06-09 13:16:02.470;193;31;89;58
44;44;2018-05-21 16:59:13.657;2018-05-21 18:24:23.413;85;34;89;55
44;44;2018-04-30 13:23:31.720;2018-04-30 15:01:15.820;98;34;89;55
44;44;2018-04-17 12:22:50.647;2018-04-17 14:17:22.860;115;27;89;62
44;44;2018-06-18 14:17:15.250;2018-06-18 15:38:47.850;81;33;89;56
44;44;2018-06-14 17:00:02.500;2018-06-14 18:26:15.257;86;34;89;55
44;44;2018-06-06 17:14:42.840;2018-06-06 19:04:51.390;110;34;89;55
44;44;2018-05-18 23:57:51.953;2018-05-19 01:26:45.207;89;32;89;57
44;44;2018-04-27 20:38:23.683;2018-04-27 22:03:29.127;85;34;89;55
44;44;2018-05-02 06:49:47.550;2018-05-02 09:05:31.430;136;34;89;55
44;44;2018-05-04 10:02:56.120;2018-05-04 11:32:16.380;90;34;93;59
44;44;2018-04-26 10:23:23.010;2018-04-26 11:47:08.000;84;34;89;55
44;44;2018-04-18 07:18:57.040;2018-04-18 09:01:42.567;103;34;87;53
44;44;2018-04-19 15:44:08.357;2018-04-19 18:21:28.290;157;33;89;56
44;44;2018-04-18 23:30:28.107;2018-04-19 01:56:24.497;146;33;89;56
44;44;2018-08-29 10:18:37.410;2018-08-29 16:09:33.297;351;33;89;56
44;44;2018-09-28 02:53:49.287;2018-09-29 00:44:44.613;1311;31;89;58
44;44;2018-09-27 14:39:29.260;2018-09-29 00:44:44.613;2045;42;89;47
44;44;2018-09-26 15:11:01.670;2018-09-29 00:44:44.613;3453;34;89;55
44;44;2018-09-26 15:14:59.663;2018-09-29 00:44:44.613;3450;34;89;55
44;44;2018-09-26 21:41:40.133;2018-09-29 00:44:44.613;3063;54;89;35
44;44;2018-09-25 21:04:30.670;2018-09-25 23:15:55.043;131;33;89;56
44;44;2018-09-25 22:45:28.313;2018-09-25 23:15:55.043;30;71;89;18
44;44;2018-08-13 12:32:14.900;2018-08-13 13:26:10.867;54;34;68;34
44;44;2018-09-24 15:41:13.140;2018-09-24 21:01:41.667;320;33;100;67
44;44;2018-09-24 10:04:29.707;2018-09-24 21:01:41.667;657;34;100;66
44;44;2018-09-24 11:06:34.400;2018-09-24 21:01:41.667;595;33;100;67
44;44;2018-09-22 12:30:16.370;2018-09-22 13:55:56.097;85;32;89;57
44;44;2018-09-20 16:26:18.623;2018-09-20 18:10:57.540;104;33;89;56
44;44;2018-09-13 20:08:27.583;2018-09-13 22:04:09.573;116;34;89;55
44;44;2018-09-10 18:53:42.200;2018-09-10 20:49:20.507;116;33;89;56
44;44;2018-09-10 03:05:36.113;2018-09-10 04:34:38.203;89;33;89;56
44;44;2018-08-22 19:07:13.050;2018-08-22 20:36:41.393;89;34;89;55
44;44;2018-08-24 01:25:08.997;2018-08-24 03:04:02.473;99;33;89;56
44;44;2018-08-02 23:30:01.680;2018-08-03 00:55:26.990;85;33;89;56
44;44;2018-08-06 12:09:33.823;2018-08-06 13:42:28.410;93;33;89;56
44;44;2018-08-16 11:50:46.193;2018-08-16 12:21:35.513;31;33;48;15
44;44;2018-08-20 11:57:55.623;2018-08-20 15:22:57.960;205;33;89;56
44;44;2018-07-18 08:28:34.003;2018-07-18 10:10:15.147;102;34;89;55
44;44;2018-07-12 16:40:19.413;2018-07-12 18:00:06.613;80;33;89;56
44;44;2018-06-21 22:52:25.900;2018-06-22 19:00:26.767;1208;85;89;4
44;44;2018-06-21 01:24:04.300;2018-06-21 02:50:22.797;86;33;89;56
44;44;2018-06-20 09:13:40.053;2018-06-20 10:38:09.037;85;34;89;55
44;44;2018-06-19 08:48:53.803;2018-06-19 10:11:22.070;83;33;89;56
44;44;2018-05-31 18:06:47.857;2018-05-31 23:10:23.623;304;33;92;59
44;44;2018-05-28 01:50:35.140;2018-05-28 08:01:53.333;371;32;89;57
44;44;2018-05-11 16:35:37.630;2018-05-12 04:51:05.630;736;34;89;55
44;44;2018-05-14 13:46:03.293;2018-05-14 15:15:54.310;89;34;89;55
44;44;2018-08-07 18:07:17.090;2018-08-07 19:26:51.573;79;34;89;55
44;44;2018-07-24 00:59:48.000;2018-07-24 14:24:18.157;805;34;89;55
44;44;2018-07-26 14:49:57.423;2018-07-26 16:29:15.690;100;34;89;55
44;44;2018-07-27 08:45:21.950;2018-07-27 10:17:12.460;92;33;89;56
44;44;2018-07-23 09:56:15.570;2018-07-23 11:19:14.933;83;34;89;55
44;44;2018-07-23 09:59:56.713;2018-07-23 11:19:14.933;80;34;89;55
44;44;2018-07-11 11:56:15.437;2018-07-11 13:03:50.767;67;34;82;48
44;44;2018-07-09 11:03:46.830;2018-07-09 12:29:40.777;86;34;93;59
44;44;2018-06-07 12:51:40.430;2018-06-07 14:43:54.940;112;34;89;55
44;44;2018-06-06 17:24:25.540;2018-06-06 19:04:51.390;100;34;89;55
44;44;2018-05-23 10:53:38.870;2018-05-23 12:27:24.753;94;34;89;55
44;44;2018-04-27 05:18:33.883;2018-04-27 06:44:34.880;86;34;89;55
44;44;2018-05-02 22:42:10.960;2018-05-03 01:27:54.843;165;33;89;56
44;44;2018-05-03 15:26:13.003;2018-05-03 18:45:05.103;199;34;89;55
44;44;2018-04-24 20:42:38.273;2018-04-24 22:34:17.137;112;34;91;57
44;44;2018-04-25 15:28:41.117;2018-04-25 16:50:12.103;82;37;89;52
44;44;2018-08-14 12:48:28.873;2018-08-14 14:17:07.910;89;33;89;56
44;44;2018-09-26 15:11:07.863;2018-09-29 00:44:44.613;3453;34;89;55
44;44;2018-09-26 15:14:15.490;2018-09-29 00:44:44.613;3450;34;89;55
44;44;2018-09-26 20:10:39.177;2018-09-29 00:44:44.613;3154;31;89;58
44;44;2018-09-26 20:33:01.043;2018-09-29 00:44:44.613;3131;31;89;58
44;44;2018-09-25 20:51:45.037;2018-09-25 23:15:55.043;144;33;89;56
44;44;2018-08-10 14:49:29.117;2018-08-10 16:13:00.467;84;33;89;56
44;44;2018-09-24 11:56:15.283;2018-09-24 21:01:41.667;545;33;100;67
44;44;2018-09-21 12:25:08.780;2018-09-22 13:55:56.097;1530;33;89;56
44;44;2018-09-21 12:35:37.000;2018-09-22 13:55:56.097;1520;33;89;56
44;44;2018-09-22 11:14:28.973;2018-09-22 13:55:56.097;161;33;89;56
44;44;2018-09-20 16:28:19.557;2018-09-20 18:10:57.540;102;33;89;56
44;44;2018-09-19 19:59:47.323;2018-09-19 21:25:04.133;86;33;89;56
44;44;2018-09-14 21:09:06.830;2018-09-14 23:26:56.290;137;32;89;57
44;44;2018-09-11 12:06:43.537;2018-09-11 13:42:35.087;96;33;89;56
44;44;2018-09-10 19:14:22.720;2018-09-10 20:49:20.507;95;33;89;56
44;44;2018-09-07 02:01:51.717;2018-09-07 03:23:25.853;82;34;89;55
44;44;2018-08-22 04:55:38.730;2018-08-22 06:23:03.250;88;34;89;55
44;44;2018-08-23 11:11:40.657;2018-08-23 12:46:00.237;95;34;89;55
44;44;2018-08-03 16:25:55.740;2018-08-03 17:52:18.930;87;33;89;56
44;44;2018-08-16 11:59:36.443;2018-08-16 12:21:35.513;22;33;48;15
44;44;2018-07-31 17:21:40.473;2018-07-31 18:41:10.063;80;34;89;55
44;44;2018-07-19 20:12:33.037;2018-07-19 22:15:42.680;123;34;89;55
44;44;2018-07-19 03:49:44.507;2018-07-19 05:41:45.310;112;34;89;55
44;44;2018-07-16 06:18:07.210;2018-07-16 08:33:46.223;135;17;89;72
44;44;2018-07-02 00:08:48.830;2018-07-02 04:41:36.750;273;32;89;57
44;44;2018-06-27 22:31:50.373;2018-06-28 01:13:07.100;162;34;89;55
44;44;2018-06-26 09:04:34.600;2018-06-26 11:04:17.747;120;34;89;55
44;44;2018-06-21 22:53:46.857;2018-06-22 19:00:26.767;1207;85;89;4
44;44;2018-06-04 12:51:38.600;2018-06-04 14:25:12.567;94;33;89;56
44;44;2018-06-01 19:14:31.873;2018-06-01 20:38:10.590;84;34;89;55
44;44;2018-05-09 08:41:25.717;2018-05-09 11:54:23.717;193;15;94;79
44;44;2018-07-24 12:24:33.170;2018-07-24 14:24:18.157;120;34;89;55
44;44;2018-07-24 12:40:53.407;2018-07-24 14:24:18.157;104;34;89;55
44;44;2018-07-25 21:24:40.637;2018-07-25 22:51:08.373;87;33;89;56
44;44;2018-07-04 16:35:29.820;2018-07-04 18:05:56.403;90;34;89;55
44;44;2018-06-18 14:19:22.937;2018-06-18 15:38:47.850;79;33;89;56
44;44;2018-06-15 22:56:00.483;2018-06-16 00:18:59.900;82;33;89;56
44;44;2018-06-13 23:28:10.297;2018-06-14 00:59:47.383;91;31;89;58
44;44;2018-06-12 10:37:55.507;2018-06-12 15:26:03.463;289;34;100;66
44;44;2018-06-06 17:03:21.977;2018-06-06 19:04:51.390;121;34;89;55
44;44;2018-05-22 10:46:34.447;2018-05-22 12:14:53.380;88;34;89;55
44;44;2018-05-18 04:13:51.477;2018-05-18 05:34:49.433;81;34;89;55
44;44;2018-05-17 03:29:41.330;2018-05-17 05:36:43.890;127;32;93;61
44;44;2018-05-16 05:02:24.480;2018-05-16 06:56:56.770;114;33;89;56
44;44;2018-05-02 22:47:37.657;2018-05-03 01:27:54.843;160;33;89;56
44;44;2018-04-20 15:56:27.970;2018-04-20 19:43:59.090;227;34;89;55
44;44;2018-04-24 12:23:17.380;2018-04-24 13:04:14.083;41;34;56;22
44;44;2018-04-24 12:24:52.113;2018-04-24 13:04:14.083;40;34;56;22
